fighter,D,L,NC,W,total
 alatengheili,1,2,0,1,4
 aoriqileng,0,3,1,0,4
 maheshate,0,1,0,1,2
 sumudaerji,0,3,0,0,3
aalon cruz,0,1,0,0,1
aalon cruz ,0,1,0,0,1
aaron brink,0,1,0,0,1
aaron phillips,0,2,0,0,2
aaron phillips ,0,2,0,0,2
aaron riley,0,5,0,0,5
aaron riley ,0,1,0,3,4
aaron rosa,0,2,0,0,2
aaron rosa ,0,0,0,1,1
aaron simpson,0,1,0,2,3
aaron simpson ,0,3,0,5,8
aaron wilkinson,0,1,0,0,1
abdul razak alhassan,0,2,0,5,7
abdul razak alhassan ,0,4,1,1,6
abdul-kareem al-selwady ,0,1,0,0,1
abdul-kerim edilov,0,0,0,1,1
abel trujillo,0,3,1,3,7
abel trujillo ,0,1,0,3,4
abner lloveras,0,1,0,0,1
abu azaitar,0,1,0,1,2
abubakar nurmagomedov,0,0,0,1,1
abubakar nurmagomedov ,0,2,0,1,3
abus magomedov,0,2,0,0,2
abus magomedov ,0,0,0,2,2
adam cella,0,1,0,0,1
adam fugitt,0,2,0,2,4
adam milstead,0,1,0,1,2
adam milstead ,0,1,1,0,2
adam wieczorek,0,0,0,2,2
adam wieczorek ,0,1,0,0,1
adam yandiev ,0,1,0,0,1
adlan amagov,0,0,0,2,2
adrian serrano,0,1,0,0,1
adrian yanez,0,2,0,1,3
adrian yanez ,0,1,0,5,6
adriano martins,0,3,0,1,4
adriano martins ,0,0,0,3,3
adriano santos,0,1,0,0,1
aiemann zahabi ,0,2,0,6,8
ailin perez,0,1,0,2,3
ailin perez ,0,0,0,2,2
aisling daly,0,1,0,0,1
aisling daly ,0,0,0,2,2
aj cunningham,0,1,0,0,1
aj dobson,0,2,0,0,2
aj dobson ,0,1,0,1,2
aj fletcher,0,2,0,0,2
aj fletcher ,0,1,0,1,2
akbarh arreola,0,2,0,1,3
akbarh arreola ,0,1,0,0,1
akihiro gono,0,2,0,0,2
akihiro gono ,0,0,0,1,1
akira corassani,0,1,0,1,2
akira corassani ,0,2,0,2,4
al iaquinta,0,2,0,5,7
al iaquinta ,0,4,0,4,8
alan baudot,0,3,0,0,3
alan baudot ,0,1,0,0,1
alan belcher,0,6,0,2,8
alan belcher ,0,0,0,7,7
alan jouban,0,2,0,3,5
alan jouban ,0,3,0,5,8
alan omer ,0,2,0,0,2
alan patrick,0,4,0,1,5
alan patrick ,0,0,1,4,5
alatengheili ,0,0,0,4,4
albert cheng ,0,1,0,0,1
albert duraev,0,1,0,1,2
albert duraev ,0,1,0,1,2
albert morales,1,2,0,0,3
albert morales ,0,2,0,1,3
albert tumenov,0,2,0,4,6
albert tumenov ,0,1,0,1,2
alberta cerra leon,0,1,0,0,1
alberto crane,0,2,0,0,2
alberto mina,0,0,0,2,2
alberto mina ,0,1,0,1,2
alberto uda,0,1,0,0,1
alberto uda ,0,1,0,0,1
alejandro perez,0,1,0,3,4
alejandro perez ,1,3,0,5,9
aleksa camur,0,2,0,0,2
aleksa camur ,0,1,0,1,2
aleksandar rakic,0,3,0,6,9
aleksandra albu,0,1,0,2,3
aleksandra albu ,0,1,0,0,1
aleksei kunchenko,0,2,0,1,3
aleksei kunchenko ,0,0,0,1,1
aleksei oleinik,0,3,0,3,6
aleksei oleinik ,0,5,0,6,11
alen amedovski,0,3,0,0,3
alen amedovski ,0,1,0,0,1
alessandro costa,0,2,0,1,3
alessandro costa ,0,0,0,1,1
alessio di chirico,0,2,0,2,4
alessio di chirico ,0,5,0,2,7
alessio sakara,0,6,0,0,6
alessio sakara ,0,2,1,6,9
alex andrade,0,1,0,0,1
alex caceres,0,6,0,3,9
alex caceres ,0,6,1,13,20
alex chambers,0,3,0,0,3
alex chambers ,0,1,0,1,2
alex da silva,0,3,0,1,4
alex garcia,0,3,0,5,8
alex garcia ,0,2,0,0,2
alex gorgees ,0,1,0,0,1
alex hunter ,0,0,0,2,2
alex karalexis,0,2,0,0,2
alex karalexis ,0,0,0,1,1
alex morono,0,6,0,8,14
alex morono ,0,2,1,5,8
alex nicholson,0,3,0,1,4
alex oliveira,0,4,0,4,8
alex oliveira ,0,6,1,7,14
alex pereira,0,0,0,4,4
alex pereira ,0,1,0,5,6
alex perez,0,3,0,5,8
alex perez ,0,2,0,2,4
alex reyes,0,2,0,0,2
alex reyes ,0,1,0,0,1
alex ricci,0,2,0,0,2
alex schoenauer,0,1,0,0,1
alex soto,0,1,0,0,1
alex soto ,0,1,0,0,1
alex stiebling,0,1,0,0,1
alex torres,0,1,0,0,1
alex white,0,4,0,3,7
alex white ,0,2,0,1,3
alexa grasso,0,1,0,6,7
alexa grasso ,1,3,0,2,6
alexander gustafsson,0,5,0,4,9
alexander gustafsson ,0,3,0,6,9
alexander hernandez,0,1,0,4,5
alexander hernandez ,0,6,0,3,9
alexander munoz,0,2,0,0,2
alexander munoz ,0,0,0,1,1
alexander volkanovski,0,1,0,5,6
alexander volkanovski ,0,1,0,8,9
alexander volkov,0,4,0,5,9
alexander volkov ,0,1,0,7,8
alexander yakovlev,0,5,0,2,7
alexander yakovlev ,0,1,0,1,2
alexandr romanov,0,3,0,0,3
alexandr romanov ,0,0,0,7,7
alexandre barros,0,1,0,0,1
alexandre dantas,0,2,0,0,2
alexandre ferreira,0,1,0,0,1
alexandre pantoja,0,1,0,3,4
alexandre pantoja ,0,2,0,10,12
alexis davis,0,3,0,1,4
alexis davis ,0,3,0,7,10
alexis dufresne,0,1,0,0,1
alexis dufresne ,0,1,0,0,1
alfonso alcarez,1,0,0,0,1
ali alqaisi,0,1,0,0,1
ali alqaisi ,0,1,0,0,1
ali bagautinov,0,3,0,3,6
ali bagautinov ,0,0,0,1,1
aliaskhab khizriev ,0,0,1,1,2
alice ardelean,0,2,0,0,2
alistair overeem,0,1,0,5,6
alistair overeem ,0,7,0,7,14
aljamain sterling,0,3,0,6,9
aljamain sterling ,0,2,0,10,12
allan goes,0,1,0,0,1
allan nascimento,0,1,0,1,2
allan nascimento ,0,0,0,1,1
allan zuniga,0,1,0,0,1
allen berube,0,1,0,0,1
allen crowder,0,1,0,1,2
allen crowder ,0,1,0,0,1
alonzo menifield,1,2,0,2,5
alonzo menifield ,0,3,0,6,9
alptekin ozkilic,0,1,0,1,2
alptekin ozkilic ,0,2,0,0,2
alvaro herrera mendoza,0,2,0,1,3
alvaro herrera mendoza ,0,1,0,0,1
alvin robinson,0,3,0,0,3
alvin robinson ,0,0,0,1,1
amanda cooper,0,3,0,1,4
amanda cooper ,0,1,0,1,2
amanda lemos,0,2,0,4,6
amanda lemos ,0,2,0,4,6
amanda nunes,0,1,0,4,5
amanda nunes ,0,1,0,12,13
amanda ribas,0,2,0,4,6
amanda ribas ,0,2,0,3,5
amar suloev,0,2,0,0,2
amaury bitetti,0,1,0,0,1
amaury bitetti ,0,0,0,1,1
amilcar alves,0,2,0,0,2
amir albazi,0,1,0,2,3
amir albazi ,0,0,0,3,3
amir sadollah,0,3,0,1,4
amir sadollah ,0,2,0,5,7
anderson dos santos,0,3,0,1,4
anderson silva,0,5,0,0,5
anderson silva ,0,2,1,17,20
andre ewell,0,4,0,1,5
andre ewell ,0,1,0,3,4
andre fialho,0,2,0,1,3
andre fialho ,0,3,0,1,4
andre fili,0,7,0,7,14
andre fili ,0,3,1,5,9
andre gusmao,0,2,0,0,2
andre lima,0,0,0,3,3
andre muniz,0,1,0,4,5
andre muniz ,0,1,0,2,3
andre pederneiras,0,1,0,0,1
andre petroski,0,0,0,3,3
andre petroski ,0,2,0,4,6
andre roberts,0,1,0,0,1
andre roberts ,0,0,0,2,2
andre soukhamthath,0,5,0,1,6
andre soukhamthath ,0,0,0,1,1
andre winner,0,3,0,0,3
andre winner ,0,1,0,2,3
andrea lee,0,4,0,3,7
andrea lee ,0,4,0,2,6
andreas michailidis,0,3,0,0,3
andreas michailidis ,0,0,0,1,1
andreas stahl,0,1,0,0,1
andreas stahl ,0,1,0,0,1
andrei arlovski,0,6,0,4,10
andrei arlovski ,0,12,1,19,32
andrei semenov,0,1,0,0,1
andrei semenov ,0,0,0,1,1
andrew craig,0,3,0,3,6
andrew craig ,0,1,0,0,1
andrew holbrook,0,3,0,2,5
andrew sanchez,0,2,0,1,3
andrew sanchez ,0,3,0,4,7
andy anderson,0,1,0,0,1
andy enz,0,3,0,0,3
andy ogle,0,1,0,0,1
andy ogle ,0,4,0,1,5
andy wang,0,1,0,0,1
ange loosa,0,2,1,1,4
ange loosa ,0,0,0,1,1
angel pacheco ,0,1,0,0,1
angela hill,0,12,0,6,18
angela hill ,0,2,0,6,8
angela magana,0,2,0,0,2
angela magana ,0,1,0,0,1
anistavio medeiros ,0,1,0,0,1
anna elmose,0,1,0,0,1
anna elmose ,0,1,0,0,1
ansar chalangov,0,2,0,0,2
anshul jubli,0,0,0,1,1
anthony birchak,0,3,0,1,4
anthony birchak ,0,1,0,1,2
anthony christodoulou,0,1,0,0,1
anthony christodoulou ,0,1,0,0,1
anthony hamilton,0,3,0,2,5
anthony hamilton ,0,4,0,1,5
anthony hernandez,0,1,0,3,4
anthony hernandez ,0,1,0,4,5
anthony ivy,0,1,0,0,1
anthony ivy ,0,1,0,0,1
anthony johnson,0,5,0,2,7
anthony johnson ,0,1,0,11,12
anthony lapsley,0,1,0,0,1
anthony lapsley ,0,1,0,0,1
anthony macias,0,2,0,0,2
anthony macias ,0,0,0,1,1
anthony njokuani,0,3,0,1,4
anthony njokuani ,0,2,0,2,4
anthony perosh,0,4,0,3,7
anthony perosh ,0,3,0,2,5
anthony pettis,0,4,0,3,7
anthony pettis ,0,5,0,8,13
anthony rocco martin,0,4,0,4,8
anthony rocco martin ,0,2,0,5,7
anthony smith,0,6,0,6,12
anthony smith ,0,5,0,6,11
anthony torres,0,1,0,0,1
anthony torres ,0,0,0,1,1
anton kuivanen,0,1,0,1,2
anton kuivanen ,0,1,0,0,1
anton turkalj,0,4,0,0,4
anton zafir,0,2,0,0,2
antoni hardonk,0,4,0,0,4
antoni hardonk ,0,0,0,4,4
antonina shevchenko,0,3,0,1,4
antonina shevchenko ,0,1,0,3,4
antonio arroyo,0,2,0,0,2
antonio arroyo ,0,1,0,0,1
antonio banuelos,0,1,0,0,1
antonio braga neto,0,1,0,0,1
antonio braga neto ,0,1,0,1,2
antonio carlos junior,0,3,0,2,5
antonio carlos junior ,0,2,1,5,8
antonio carvalho,0,1,0,0,1
antonio carvalho ,0,1,0,2,3
antonio dos santos,0,2,0,0,2
antonio mckee,0,1,0,0,1
antonio mendes,0,2,0,0,2
antonio rodrigo nogueira,0,4,0,0,4
antonio rodrigo nogueira ,0,2,0,5,7
antonio silva,1,4,0,2,7
antonio silva ,0,3,0,1,4
antonio trocoli,0,2,0,0,2
anying wang,0,0,0,1,1
anying wang ,0,1,0,0,1
aoriqileng ,0,1,0,3,4
ariane carnelossi,0,0,0,3,3
ariane carnelossi ,0,2,0,0,2
ariane da silva ,0,2,0,0,2
ariane lipski,0,4,0,1,5
ariane lipski ,0,1,0,5,6
ariel beck ,0,1,0,0,1
arjan bhullar,0,0,0,1,1
arjan bhullar ,0,1,0,2,3
arman tsarukyan,0,1,0,4,5
arman tsarukyan ,0,1,0,5,6
armen petrosyan,0,2,0,0,2
armen petrosyan ,0,0,0,3,3
arnold allen,0,1,0,3,4
arnold allen ,0,1,0,8,9
artem lobov,0,2,0,0,2
artem lobov ,0,3,0,2,5
asbel cancio,0,1,0,0,1
ashkan mokhtarian,0,2,0,0,2
ashlee evans-smith,0,2,0,2,4
ashlee evans-smith ,0,4,0,1,5
ashley yoder,0,5,0,0,5
ashley yoder ,0,3,0,3,6
askar askarov,1,0,0,3,4
askar askarov ,0,1,0,0,1
askar mozharov,0,1,0,0,1
aspen ladd,0,1,0,1,2
aspen ladd ,0,2,0,3,5
assu almabayev,0,0,0,1,1
assuerio silva,0,3,0,0,3
asu almabayev,0,0,0,2,2
asu almabayev ,0,0,0,1,1
augusto mendes,0,2,0,1,3
augusto montano ,0,2,0,1,3
augusto sakai,0,2,0,3,5
augusto sakai ,0,2,0,2,4
austen lane,0,1,0,0,1
austen lane ,0,1,1,1,3
austin arnett,0,2,0,1,3
austin arnett ,0,1,0,0,1
austin hubbard,0,4,0,1,5
austin hubbard ,0,2,0,3,5
austin lingo,0,1,0,1,2
austin lingo ,0,2,0,1,3
austin springer,0,1,0,0,1
azamat gashimov,0,2,0,0,2
azamat murzakanov,0,0,0,3,3
azamat murzakanov ,0,0,0,1,1
azat maksum,0,0,0,1,1
azat maksum ,0,1,0,0,1
azunna anyanwu,0,1,0,0,1
baergeng jieleyisi ,0,1,0,0,1
barb honchak,0,1,0,0,1
barb honchak ,0,1,0,0,1
bart palaszewski,0,2,0,1,3
bart palaszewski ,0,1,0,0,1
bartosz fabinski,0,2,0,2,4
bartosz fabinski ,0,1,0,1,2
bas rutten ,0,0,0,2,2
bassil hafez,0,1,0,1,2
bassil hafez ,0,1,0,0,1
batgerel danaa,0,3,0,0,3
bea malecki,0,0,0,1,1
bea malecki ,0,1,0,1,2
bec rawlings,0,2,0,0,2
bec rawlings ,0,3,0,2,5
bekzat almakhan,0,1,0,0,1
belal muhammad,0,2,1,9,12
belal muhammad ,0,1,0,6,7
ben alloway,0,1,0,0,1
ben alloway ,0,1,0,1,2
ben askren,0,2,0,1,3
ben earwood ,0,0,0,1,1
ben nguyen,0,3,0,2,5
ben nguyen ,0,0,0,2,2
ben rothwell,0,4,0,4,8
ben rothwell ,0,4,0,5,9
ben saunders,0,6,0,4,10
ben saunders ,0,4,0,5,9
ben sosoli,0,0,1,0,1
ben sosoli ,0,1,0,0,1
ben wall,0,1,0,0,1
ben wall ,0,1,0,0,1
benardo sopaj,0,1,0,0,1
beneil dariush,0,3,0,8,11
beneil dariush ,1,3,0,8,12
benito lopez,0,1,0,1,2
benito lopez ,0,1,0,1,2
benji radach,0,1,0,0,1
benji radach ,0,0,1,1,2
benoit saint denis,0,3,0,3,6
benoit saint denis ,0,0,0,2,2
benson henderson,0,1,0,4,5
benson henderson ,0,2,0,7,9
bentley syler ,0,1,0,0,1
bernardo magalhaes,0,2,0,0,2
besam yousef,0,2,0,0,2
bethe correia,0,3,0,4,7
bethe correia ,1,3,0,1,5
bevon lewis,0,2,0,0,2
bevon lewis ,0,1,0,1,2
bharat kandare,0,1,0,0,1
bibulatov magomed,0,1,0,1,2
bibulatov magomed ,0,1,0,0,1
bill algeo,0,4,0,2,6
bill algeo ,0,1,0,3,4
bill mahood,0,1,0,0,1
billy miles,0,1,0,0,1
billy quarantillo,0,4,0,1,5
billy quarantillo ,0,1,0,5,6
billy ray goff ,0,1,0,0,1
bj penn,0,7,0,1,8
bj penn ,2,6,0,11,19
blagoy ivanov,0,4,0,1,5
blagoy ivanov ,0,1,0,2,3
blake bilder,0,2,0,1,3
blood diamond,0,2,0,0,2
blood diamond ,0,1,0,0,1
bo nickal ,0,0,0,4,4
bob cook ,0,0,0,1,1
bob gilstrap,0,1,0,0,1
bobby green,1,5,0,8,14
bobby green ,0,5,1,5,11
bobby hoffman,0,2,0,0,2
bobby hoffman ,0,0,1,0,1
bobby moffett,0,2,1,0,3
bobby nash,0,2,0,0,2
bobby nash ,0,1,0,0,1
bobby southworth,0,1,0,0,1
bobby voelker,0,3,0,0,3
bobby voelker ,0,1,0,0,1
bogdan guskov,0,1,0,2,3
bojan mihajlovic,0,1,0,0,1
bojan mihajlovic ,0,2,0,0,2
bojan velickovic,1,2,0,2,5
bojan velickovic ,0,1,0,0,1
bolaji oki ,0,1,0,1,2
boston salmon,0,1,0,0,1
boston salmon ,0,1,0,0,1
brad blackburn,0,2,0,0,2
brad blackburn ,0,0,0,3,3
brad gumm,0,1,0,0,1
brad gumm ,1,0,0,0,1
brad imes,0,3,0,0,3
brad katona,0,0,0,1,1
brad katona ,0,4,0,3,7
brad kohler,0,1,0,0,1
brad kohler ,0,0,0,1,1
brad morris,0,2,0,0,2
brad pickett,0,1,0,1,2
brad pickett ,0,8,0,4,12
brad riddell,0,0,0,1,1
brad riddell ,0,3,0,3,6
brad scott,0,1,0,1,2
brad scott ,0,4,0,2,6
brad tavares,0,1,0,8,9
brad tavares ,0,9,0,7,16
brady hiestand,0,1,0,0,1
brady hiestand ,0,0,0,3,3
branden lee hinkle,0,2,0,0,2
branden lee hinkle ,0,0,0,1,1
brandon davis,0,6,0,1,7
brandon davis ,0,1,0,1,2
brandon jenkins,0,2,0,0,2
brandon melendez,0,1,0,0,1
brandon moreno,1,1,0,5,7
brandon moreno ,1,4,0,5,10
brandon royval,0,3,0,3,6
brandon royval ,0,0,0,4,4
brandon thatch,0,2,0,2,4
brandon thatch ,0,2,0,0,2
brandon vera,0,6,0,0,6
brandon vera ,0,1,1,8,10
brandon wolff,0,2,0,0,2
braxton smith ,0,1,0,0,1
brendan allen,0,1,0,5,6
brendan allen ,0,2,0,7,9
brendan loughnane ,0,1,0,0,1
brendan o'reilly,0,2,0,1,3
brendan o'reilly ,0,1,0,0,1
brendan schaub,0,4,0,1,5
brendan schaub ,0,1,0,5,6
brendon marotte,0,2,0,0,2
brendson ribeiro,0,2,0,1,3
brett johns,0,2,0,1,3
brett johns ,0,0,0,4,4
brian bowles,0,1,0,0,1
brian bowles ,0,1,0,2,3
brian camozzi,0,3,0,0,3
brian cobb,0,1,0,0,1
brian ebersole,0,0,0,3,3
brian ebersole ,0,3,0,2,5
brian foster,0,2,0,1,3
brian foster ,0,0,0,2,2
brian gassaway,0,1,0,0,1
brian geraghty,0,1,0,0,1
brian houston,0,2,0,0,2
brian johnston,0,4,0,0,4
brian johnston ,0,0,0,2,2
brian kelleher,0,4,0,4,8
brian kelleher ,0,5,0,4,9
brian melancon,0,1,0,1,2
brian ortega,0,2,1,5,8
brian ortega ,0,2,0,3,5
brian stann,0,5,0,1,6
brian stann ,0,0,0,5,5
brianna van buren,0,1,0,1,2
bristol marunde,0,1,0,0,1
bristol marunde ,0,1,0,0,1
brock jardine,0,2,0,0,2
brock larson,0,3,0,0,3
brock larson ,0,0,0,3,3
brock lesnar,0,1,0,0,1
brock lesnar ,0,2,1,4,7
brodie farber,0,2,0,0,2
brogan walker,0,1,0,0,1
brogan walker ,0,1,0,0,1
brok weaver,0,1,0,0,1
brok weaver ,0,1,0,1,2
bruna brasil,0,1,0,2,3
bruna brasil ,0,1,0,0,1
brunno ferreira,0,0,0,2,2
brunno ferreira ,0,1,0,1,2
bruno korea ,0,1,0,0,1
bruno santos,0,1,0,1,2
bruno santos ,0,1,0,0,1
bruno silva,0,4,1,6,11
bruno silva ,0,3,0,2,5
bruno souza,0,2,0,0,2
bryan barberena,0,6,0,6,12
bryan barberena ,0,4,0,3,7
bryan battle,0,0,0,3,3
bryan battle ,0,1,1,4,6
bryan caraway,0,3,0,3,6
bryan caraway ,0,1,0,3,4
bryce mitchell,0,1,0,2,3
bryce mitchell ,0,1,0,6,7
bubba bush,0,0,1,0,1
bubba bush ,0,1,0,0,1
buddy roberts,0,1,0,0,1
buddy roberts ,0,0,0,1,1
byron bloodworth,0,2,0,0,2
cain carrizosa,0,2,0,0,2
cain velasquez,0,1,0,2,3
cain velasquez ,0,2,0,10,12
caio borralho,0,0,0,3,3
caio borralho ,0,0,0,4,4
caio machado,0,2,0,0,2
caio machado ,0,1,0,0,1
caio magalhaes,0,3,0,1,4
caio magalhaes ,0,0,0,3,3
cal worsham,0,2,0,0,2
cal worsham ,0,0,0,1,1
cale yarbrough,0,1,0,0,1
callan potter ,0,2,0,1,3
calvin kattar,0,3,0,3,6
calvin kattar ,0,3,0,4,7
cameron dollar,0,1,0,0,1
cameron else,0,2,0,0,2
cameron saaiman,0,2,0,1,3
cameron saaiman ,0,0,0,2,2
cameron smotherman,0,0,0,1,1
cameron vancamp,0,2,0,0,2
caol uno,1,4,0,0,5
caol uno ,1,1,0,3,5
caolan loughran,0,2,0,1,3
carl deaton,0,2,0,0,2
carla esparza,0,1,0,3,4
carla esparza ,0,5,0,7,12
carli judice ,0,1,0,0,1
carlo pedersoli jr.,0,2,0,1,3
carlo prater,0,2,0,1,3
carlos barreto,0,1,0,0,1
carlos candelario,0,1,0,0,1
carlos candelario ,0,1,0,0,1
carlos condit,0,4,0,2,6
carlos condit ,0,6,0,7,13
carlos eduardo rocha,0,2,0,1,3
carlos felipe,0,1,0,1,2
carlos felipe ,0,1,0,2,3
carlos hernandez,0,3,0,2,5
carlos hernandez ,0,0,0,1,1
carlos huachin,0,2,0,0,2
carlos mota,0,1,0,0,1
carlos newton,0,4,0,0,4
carlos newton ,0,0,0,3,3
carlos prates,0,0,0,4,4
carlos ulberg,0,1,0,2,3
carlos ulberg ,0,0,0,5,5
carlos vera,0,1,0,0,1
carls john de tomas,0,1,0,0,1
carls john de tomas ,0,1,0,0,1
carlston harris,0,2,0,3,5
carlston harris ,0,0,0,1,1
carlton minus,0,1,0,0,1
carlton minus ,0,1,0,0,1
carmelo marrero,0,3,0,0,3
carmelo marrero ,0,0,0,1,1
caros fodor,0,1,0,0,1
casey kenney,0,2,0,4,6
casey kenney ,0,1,0,1,2
casey o'neill,0,1,0,3,4
casey o'neill ,0,1,0,2,3
cat zingano,0,1,0,1,2
cat zingano ,0,3,0,2,5
cathal pendred,0,0,0,1,1
cathal pendred ,0,2,0,3,5
cb dollaway,0,6,0,5,11
cb dollaway ,0,3,0,6,9
cesar almeida,0,0,0,1,1
cesar almeida ,0,1,0,1,2
cesar arzamendia ,0,2,0,0,2
cesar marscucci ,0,0,0,1,1
cezar ferreira,0,3,0,2,5
cezar ferreira ,0,3,0,7,10
chad anheliger,0,0,0,1,1
chad anheliger ,0,3,0,1,4
chad griggs,0,2,0,0,2
chad laprise,0,2,0,0,2
chad laprise ,0,2,0,6,8
chad mendes,0,3,0,1,4
chad mendes ,0,2,0,8,10
chad reiner,0,2,0,0,2
chael sonnen,0,7,0,1,8
chael sonnen ,0,0,0,6,6
chan sung jung,0,3,0,4,7
chan sung jung ,0,1,0,3,4
chan-mi jeon,0,2,0,0,2
chance rencountre,0,2,0,2,4
changho lee,0,0,0,1,1
charalampos grigoriou,0,1,0,0,1
charalampos grigoriou ,0,1,0,0,1
charles byrd,0,1,0,1,2
charles byrd ,0,2,0,0,2
charles johnson,0,3,0,2,5
charles johnson ,0,1,0,4,5
charles jourdain,0,4,0,4,8
charles jourdain ,1,3,0,3,7
charles mccarthy,0,2,0,0,2
charles mccarthy ,0,0,0,1,1
charles oliveira,0,7,1,11,19
charles oliveira ,0,3,0,12,15
charles radtke,0,0,0,3,3
charles radtke ,0,1,0,0,1
charles rosa,0,6,0,0,6
charles rosa ,0,2,0,5,7
charlie brenneman,0,6,0,0,6
charlie brenneman ,0,1,0,4,5
charlie campbell,0,0,0,2,2
charlie ontiveros,0,3,0,0,3
charlie valencia,0,1,0,0,1
charlie ward ,0,2,0,0,2
chas skelly,0,2,0,2,4
chas skelly ,0,1,1,6,8
chase gormley,0,2,0,0,2
chase hooper,0,1,0,1,2
chase hooper ,0,2,0,6,8
chase sherman,0,8,0,2,10
chase sherman ,0,3,0,2,5
che mills,0,1,0,1,2
che mills ,0,0,1,1,2
cheick kongo,0,6,0,0,6
cheick kongo ,1,0,0,11,12
chelsea chandler,0,2,0,2,4
chepe mariscal,0,0,0,4,4
cheyanne vlismas ,0,2,0,2,4
chico camus,0,3,0,2,5
chico camus ,0,1,1,1,3
chidi njokuani ,0,2,0,4,6
chris avila,0,2,0,0,2
chris barnett,0,1,0,2,3
chris barnett ,0,1,0,0,1
chris beal,0,2,0,0,2
chris beal ,0,1,0,2,3
chris brennan,0,2,0,0,2
chris brennan ,0,0,0,1,1
chris camozzi,0,6,0,3,9
chris camozzi ,0,4,0,6,10
chris cariaso,0,3,0,3,6
chris cariaso ,0,3,0,4,7
chris clements,0,1,0,2,3
chris clements ,0,1,1,0,2
chris condo,0,1,0,0,1
chris cope,0,1,0,1,2
chris cope ,0,1,0,0,1
chris curtis,0,2,1,2,5
chris curtis ,0,1,0,3,4
chris daukaus,0,4,0,2,6
chris daukaus ,0,0,0,2,2
chris de la rocha,0,1,0,1,2
chris de la rocha ,0,2,0,0,2
chris dempsey,0,2,0,1,3
chris dempsey ,0,1,0,0,1
chris duncan,0,1,0,1,2
chris duncan ,0,0,0,2,2
chris fishgold,0,3,0,1,4
chris gruetzemacher,0,2,0,1,3
chris gruetzemacher ,0,2,0,2,4
chris gutierrez,0,3,0,4,7
chris gutierrez ,1,0,0,5,6
chris haseman,0,1,0,0,1
chris heatherly,0,2,0,0,2
chris holdsworth ,0,0,0,2,2
chris indich,0,1,0,0,1
chris indich ,0,1,0,0,1
chris kelades,0,2,0,1,3
chris kelades ,0,0,0,1,1
chris leben,0,5,0,1,6
chris leben ,0,5,0,11,16
chris liguori,0,1,0,0,1
chris lytle,0,10,0,2,12
chris lytle ,0,0,0,8,8
chris padilla,0,0,0,2,2
chris price,0,2,0,0,2
chris sanford,0,1,0,0,1
chris saunders,0,1,0,0,1
chris spang ,0,1,0,0,1
chris tickle,0,1,0,0,1
chris tuchscherer,0,3,0,0,3
chris tuchscherer ,0,0,0,1,1
chris wade,0,1,0,2,3
chris wade ,0,1,0,3,4
chris weidman,0,2,0,7,9
chris weidman ,0,6,0,5,11
chris wilson,0,3,0,0,3
chris wilson ,0,0,0,1,1
christian aguilera,0,1,0,1,2
christian aguilera ,0,1,0,0,1
christian colombo,1,2,0,0,3
christian duncan ,0,0,0,1,1
christian leroy duncan,0,1,0,0,1
christian leroy duncan ,0,1,0,2,3
christian morecraft,0,2,0,1,3
christian morecraft ,0,1,0,0,1
christian rodriguez,0,2,0,1,3
christian rodriguez ,0,0,0,3,3
christian wellisch,0,3,0,0,3
christian wellisch ,0,0,0,2,2
christina marks ,0,1,0,0,1
christophe leninger,0,2,0,0,2
christos giagos,0,7,0,4,11
christos giagos ,0,1,0,2,3
chuck liddell,0,6,0,0,6
chuck liddell ,0,1,0,16,17
chuck o'neil ,0,1,0,0,1
cindy dandois,0,1,0,0,1
ciryl gane,0,2,0,3,5
ciryl gane ,0,0,0,7,7
cj fernandes,1,0,0,0,1
cj keith,0,2,0,0,2
cj vergara,0,1,0,1,2
cj vergara ,0,3,0,2,5
claude patrick,0,0,0,3,3
claude patrick ,0,1,0,0,1
claudia gadelha,0,1,0,0,1
claudia gadelha ,0,4,0,7,11
claudio puelles,0,2,0,1,3
claudio puelles ,0,1,0,4,5
claudio ribeiro,0,2,0,1,3
claudio ribeiro ,0,1,0,0,1
claudio silva,0,1,0,2,3
claudio silva ,0,2,0,3,5
clay collard,0,2,0,1,3
clay collard ,0,1,0,0,1
clay guida,0,9,0,3,12
clay guida ,0,10,0,15,25
clay harvison,0,1,0,0,1
clay harvison ,0,1,0,1,2
clayton carpenter ,0,0,0,2,2
clifford starks,0,1,0,1,2
clifford starks ,0,1,0,0,1
clint hester,0,3,0,2,5
clint hester ,0,0,0,2,2
cm punk ,0,1,1,0,2
cody brundage,0,2,1,3,6
cody brundage ,0,3,0,1,4
cody donovan,0,0,0,1,1
cody donovan ,0,3,0,0,3
cody durden,1,3,0,2,6
cody durden ,0,2,0,4,6
cody east,0,1,0,0,1
cody east ,0,1,0,0,1
cody garbrandt,0,4,0,4,8
cody garbrandt ,0,2,0,5,7
cody gibson,0,4,0,3,7
cody gibson ,0,1,0,0,1
cody haddon,0,0,0,1,1
cody mckenzie,0,2,0,1,3
cody mckenzie ,0,2,0,2,4
cody pfister,0,3,0,1,4
cody stamann,0,3,0,4,7
cody stamann ,1,4,0,3,8
colby covington,0,4,0,7,11
colby covington ,0,1,0,5,6
cole escovedo,0,2,0,0,2
cole escovedo ,0,1,0,0,1
cole miller,0,4,0,1,5
cole miller ,0,5,1,9,15
cole smith,0,0,0,1,1
cole smith ,0,2,0,0,2
cole williams,0,1,0,0,1
cole williams ,0,1,0,0,1
colin fletcher,0,1,0,0,1
colin fletcher ,0,1,0,0,1
colin robinson,0,2,0,0,2
collin anglin,0,1,0,0,1
collin anglin ,0,1,0,0,1
collin hart,0,1,0,0,1
colton smith ,0,3,0,1,4
connor matthews,0,1,0,0,1
conor mcgregor,0,3,0,6,9
conor mcgregor ,0,1,0,4,5
constantinos philippou,0,2,0,4,6
constantinos philippou ,0,2,0,2,4
corey anderson,0,3,0,4,7
corey anderson ,0,2,0,6,8
corey hill,0,2,0,0,2
corey hill ,0,0,0,1,1
cortavious romious,0,1,0,0,1
cortney casey,0,6,0,2,8
cortney casey ,0,3,0,4,7
cory hendricks ,0,1,0,0,1
cory mckenna,0,2,0,2,4
cory mckenna ,0,1,0,1,2
cory sandhagen,0,2,0,5,7
cory sandhagen ,0,2,0,5,7
cory walmsley,0,1,0,0,1
court mcgee,0,2,0,1,3
court mcgee ,0,10,0,10,20
courtney turner,0,1,0,0,1
crafton wallace,0,2,0,0,2
craig white,0,2,0,0,2
cristian quinonez,0,1,0,1,2
cristian quinonez ,0,1,0,0,1
cristiane justino ,0,1,0,6,7
cristiano marcello ,0,3,0,1,4
cristina stanciu,0,2,0,0,2
cub swanson,0,3,0,1,4
cub swanson ,0,7,0,14,21
cung le,0,2,0,1,3
cung le ,0,0,0,1,1
curt warburton,0,2,0,1,3
curtis blaydes,0,3,1,5,9
curtis blaydes ,0,2,0,8,10
curtis millender,0,1,0,1,2
curtis millender ,0,1,0,2,3
curtis stout,0,2,0,0,2
cynthia calvillo,1,2,0,4,7
cynthia calvillo ,0,4,0,2,6
cyril asker,0,2,0,1,3
cyril asker ,0,1,0,1,2
cyrille diabate,0,1,0,2,3
cyrille diabate ,0,3,0,2,5
da woon jung,0,3,0,0,3
da woon jung ,0,1,0,0,1
da'mon blackshear,1,1,0,1,3
da'mon blackshear ,0,2,0,2,4
da-un jung,0,0,0,1,1
da-un jung ,1,0,0,3,4
daichi abe,0,2,0,0,2
daichi abe ,0,0,0,1,1
daiju takase,0,3,0,0,3
dakota bush,0,1,0,0,1
dakota bush ,0,1,0,0,1
dalcha lungiambula,0,3,0,0,3
dalcha lungiambula ,0,2,0,2,4
dale hartt,0,2,0,0,2
dale hartt ,0,0,0,1,1
damacio page,0,2,0,0,2
damacio page ,0,1,0,0,1
damarques johnson,0,2,0,0,2
damarques johnson ,0,4,0,4,8
damian grabowski,0,2,0,0,2
damian grabowski ,0,1,0,0,1
damian stasiak,0,1,0,2,3
damian stasiak ,0,3,0,0,3
damien brown,0,1,0,1,2
damien brown ,0,3,0,1,4
damir hadzovic,0,4,0,3,7
damir hadzovic ,0,1,0,1,2
damir ismagulov,0,1,0,2,3
damir ismagulov ,0,1,0,3,4
damon jackson,0,5,1,3,9
damon jackson ,1,1,0,3,5
dan argueta,0,1,0,0,1
dan argueta ,0,3,1,1,5
dan barrera,0,1,0,0,1
dan bobish,0,1,0,0,1
dan bobish ,0,0,0,1,1
dan christison,0,1,0,0,1
dan christison ,0,0,0,1,1
dan cramer,0,1,0,0,1
dan cramer ,0,0,0,1,1
dan evensen,0,2,0,0,2
dan hardy,0,2,0,0,2
dan hardy ,0,2,0,6,8
dan henderson,0,8,0,3,11
dan henderson ,0,1,0,6,7
dan hooker,0,6,0,7,13
dan hooker ,0,2,0,7,9
dan ige,0,4,0,3,7
dan ige ,0,3,0,7,10
dan lauzon,0,3,0,0,3
dan miller,0,4,0,1,5
dan miller ,0,3,0,5,8
dan moret,0,3,0,0,3
dan severn,0,3,0,0,3
dan severn ,0,0,0,8,8
dan stittgen,0,1,0,0,1
dan stittgen ,0,1,0,0,1
danaa batgerel,0,1,0,0,1
danaa batgerel ,0,0,0,3,3
daniel barez,0,1,0,0,1
daniel barez ,0,0,0,1,1
daniel cormier,0,2,0,3,5
daniel cormier ,0,1,1,8,10
daniel da silva,0,1,0,0,1
daniel da silva ,0,2,0,0,2
daniel jolly,0,1,0,0,1
daniel jolly ,0,1,0,0,1
daniel kelly,0,2,0,2,4
daniel kelly ,0,2,0,4,6
daniel lacerda,0,2,1,0,3
daniel marcos,0,0,0,4,4
daniel marcos ,0,0,1,0,1
daniel omielanczuk,0,2,0,2,4
daniel omielanczuk ,0,3,0,2,5
daniel pineda,0,7,1,3,11
daniel pineda ,0,1,0,2,3
daniel roberts,0,2,0,2,4
daniel roberts ,0,2,0,1,3
daniel rodriguez,0,2,0,4,6
daniel rodriguez ,0,2,0,4,6
daniel santos,0,1,0,1,2
daniel santos ,0,0,0,1,1
daniel sarafian,0,1,0,0,1
daniel sarafian ,0,3,0,2,5
daniel spitz,0,2,0,1,3
daniel spitz ,0,1,0,0,1
daniel spohn,0,1,0,0,1
daniel teymur,0,3,0,0,3
daniel teymur ,0,1,0,1,2
daniel zellhuber,0,1,0,1,2
daniel zellhuber ,0,1,0,2,3
danielle taylor,0,1,0,2,3
danielle taylor ,0,2,0,0,2
danillo villefort,0,1,0,0,1
danilo belluardo,0,2,0,0,2
danilo marques,0,2,0,2,4
danny abbadi,0,2,0,0,2
danny barlow,0,0,0,1,1
danny barlow ,0,0,0,1,1
danny castillo,0,5,0,3,8
danny castillo ,0,2,0,4,6
danny chavez,0,2,0,1,3
danny chavez ,1,0,0,0,1
danny downes,0,1,0,0,1
danny downes ,0,1,0,0,1
danny henry,0,1,0,0,1
danny henry ,0,1,0,2,3
danny martinez,0,2,0,1,3
danny martinez ,0,1,0,0,1
danny mitchell,0,2,0,0,2
danny roberts,0,3,0,1,4
danny roberts ,0,4,0,6,10
danny silva,0,0,0,1,1
dante rivera,0,1,0,0,1
danyelle wolf,0,1,0,0,1
daria zhelezniakova,0,1,0,1,2
darian weeks,0,2,0,0,2
darian weeks ,0,1,0,0,1
darko stosic,0,1,0,1,2
darko stosic ,0,2,0,0,2
daron cruickshank,0,3,1,2,6
daron cruickshank ,0,3,0,4,7
darrel gholar,0,1,0,0,1
darrell horcher,0,3,0,1,4
darrell montague,0,2,0,0,2
darrell montague ,0,1,0,0,1
darren elkins,0,3,0,7,10
darren elkins ,0,7,0,12,19
darren stewart,0,4,2,5,11
darren stewart ,0,3,0,0,3
darren till,1,3,0,4,8
darren till ,0,2,0,2,4
darren uyenoyama,0,1,0,1,2
darren uyenoyama ,0,1,0,1,2
darrick minner,0,3,0,1,4
darrick minner ,0,1,0,1,2
darrill schoonover,0,1,0,0,1
darrius flowers,0,3,0,0,3
dashon johnson,0,2,0,0,2
dave beneteau,0,3,0,0,3
dave beneteau ,0,0,0,3,3
dave berry,0,1,0,0,1
dave galera,0,1,0,0,1
dave herman,0,4,0,0,4
dave herman ,0,0,0,1,1
dave menne,0,4,0,0,4
dave menne ,0,0,0,2,2
dave strasser,0,1,0,0,1
dave strasser ,0,0,0,1,1
davey grant,0,2,0,4,6
davey grant ,0,4,0,3,7
davi ramos,0,2,0,1,3
davi ramos ,0,1,0,3,4
david abbott,0,10,0,0,10
david abbott ,0,0,0,8,8
david baron,0,1,0,0,1
david bielkheden,0,2,0,0,2
david bielkheden ,0,0,0,1,1
david branch,0,2,0,3,5
david branch ,0,3,0,1,4
david dodd,0,2,0,0,2
david dvorak,0,1,0,2,3
david dvorak ,0,2,0,1,3
david heath,0,3,0,0,3
david heath ,0,0,0,2,2
david hood,0,1,0,0,1
david kaplan,0,2,0,0,2
david lee,0,2,0,0,2
david levicki,0,1,0,0,1
david loiseau,0,4,0,0,4
david loiseau ,0,1,0,4,5
david michaud,0,1,0,0,1
david michaud ,0,1,0,1,2
david mitchell,0,4,0,1,5
david onama,0,2,0,2,4
david onama ,0,0,0,3,3
david roberts,0,1,0,0,1
david terrell,0,1,0,0,1
david terrell ,0,0,0,2,2
david teymur,0,1,0,2,3
david teymur ,0,0,0,3,3
david velasquez,0,1,0,0,1
david zawada,0,3,0,1,4
david zawada ,0,1,0,0,1
dean barry ,0,1,0,0,1
dean lister,0,2,0,0,2
dean lister ,0,0,0,4,4
deanna bennett ,1,0,0,0,1
deiveson figueiredo,0,2,0,7,9
deiveson figueiredo ,1,2,0,6,9
delson heleno ,0,1,0,0,1
demetrious johnson,0,1,0,3,4
demetrious johnson ,1,1,0,12,14
demian maia,0,5,0,3,8
demian maia ,0,6,0,19,25
denis kang,0,2,0,0,2
denis kang ,0,0,0,1,1
denis stojnic,0,2,0,0,2
denis tiuliulin,0,5,0,0,5
denis tiuliulin ,0,0,0,1,1
denise gomes,0,1,0,4,5
denise gomes ,0,1,0,0,1
dennis bermudez,0,2,0,1,3
dennis bermudez ,0,5,0,9,14
dennis buzukja,0,1,0,0,1
dennis buzukja ,0,2,0,1,3
dennis hallman,0,4,0,3,7
dennis hallman ,0,1,0,1,2
dennis siver,0,6,0,3,9
dennis siver ,0,2,1,9,12
denys bondar,0,3,0,0,3
dequan townsend,0,3,0,0,3
dequan townsend ,0,1,0,0,1
derek brunson,0,5,0,4,9
derek brunson ,0,2,0,10,12
derek downey,0,1,0,0,1
deron winn,0,2,0,0,2
deron winn ,0,1,0,2,3
derrick krantz,0,2,0,0,2
derrick lewis,0,4,0,3,7
derrick lewis ,0,6,0,16,22
derrick noble,0,1,0,0,1
desmond green,0,3,0,2,5
desmond green ,0,0,0,2,2
devin clark,0,5,0,4,9
devin clark ,0,4,0,4,8
devin powell ,0,3,0,1,4
devonte smith ,0,3,0,3,6
dhiego lima,0,3,0,3,6
dhiego lima ,0,4,0,1,5
diana belbita,0,3,0,0,3
diana belbita ,0,2,0,2,4
diego brandao,0,2,0,1,3
diego brandao ,0,2,0,5,7
diego ferreira,0,1,0,7,8
diego ferreira ,0,4,0,3,7
diego lopes,0,1,0,3,4
diego lopes ,0,0,0,2,2
diego nunes,0,2,0,3,5
diego nunes ,0,1,0,0,1
diego rivas,0,1,0,1,2
diego rivas ,0,1,0,1,2
diego sanchez,0,7,0,1,8
diego sanchez ,0,6,0,18,24
diego saraiva,0,3,0,0,3
dieusel berto,0,1,0,0,1
dileno lopes,0,2,0,0,2
din thomas,0,4,0,0,4
din thomas ,0,0,0,5,5
dione barbosa,0,1,0,0,1
dione barbosa ,0,0,0,1,1
dmitri stepanov,0,1,0,0,1
dmitrii smoliakov,0,2,0,0,2
dmitrii smoliakov ,0,1,0,0,1
dmitry sosnovskiy,0,0,0,1,1
dokonjonosuke mishima,0,2,0,0,2
domingo pilarte,0,1,0,0,1
domingo pilarte ,0,1,1,0,2
dominic waters,0,3,0,0,3
dominick cruz,0,2,0,2,4
dominick cruz ,0,1,0,5,6
dominick reyes,0,1,0,5,6
dominick reyes ,0,3,0,3,6
dominique steele,0,4,0,0,4
dominique steele ,0,0,0,1,1
don frye,0,1,0,0,1
don frye ,0,0,0,9,9
don madge,0,0,0,1,1
don madge ,0,0,0,1,1
don shainis,0,2,0,0,2
don'tale mayes,0,5,0,1,6
don'tale mayes ,0,1,0,3,4
donald cerrone,0,8,0,5,13
donald cerrone ,0,6,1,18,25
dong hyun kim,0,2,1,3,6
dong hyun kim ,0,2,0,10,12
dong hyun ma,0,4,0,2,6
dong hyun ma ,0,1,0,1,2
donghun choi,0,0,0,1,1
dongi yang,0,3,0,1,4
dongi yang ,0,0,0,1,1
donnie chappell,0,1,0,0,1
donny walker,0,2,0,0,2
dooho choi,0,2,0,2,4
dooho choi ,1,1,0,3,5
dorian price,0,1,0,0,1
doug evans,0,2,0,0,2
douglas silva de andrade,0,2,0,2,4
douglas silva de andrade ,0,4,0,5,9
drakkar klose,0,3,0,6,9
drakkar klose ,0,0,0,3,3
drako rodriguez,0,2,0,0,2
drew dober,0,7,1,4,12
drew dober ,0,3,0,9,12
drew fickett,0,3,0,0,3
drew fickett ,0,0,0,4,4
drew mcfedries,0,5,0,0,5
drew mcfedries ,0,0,0,4,4
dricus du plessis,0,0,0,7,7
dricus du plessis ,0,0,0,1,1
duane ludwig,0,3,0,1,4
duane ludwig ,0,2,0,3,5
duda santana,0,1,0,0,1
dusko todorovic,0,4,0,3,7
dusko todorovic ,0,1,0,0,1
dustin hazelett,0,4,0,0,4
dustin hazelett ,0,1,0,5,6
dustin jacoby,1,3,0,1,5
dustin jacoby ,0,3,0,7,10
dustin kimura,0,3,0,1,4
dustin kimura ,0,0,0,1,1
dustin neace,0,1,0,0,1
dustin ortiz,0,4,0,3,7
dustin ortiz ,0,2,0,5,7
dustin pague,0,2,0,0,2
dustin pague ,0,3,0,1,4
dustin poirier,0,5,1,3,9
dustin poirier ,0,3,0,19,22
dustin stoltzfus,0,4,0,3,7
dustin stoltzfus ,0,1,0,0,1
dwayne cason,0,1,0,0,1
dwayne cason ,0,0,0,1,1
dwight grant,0,3,0,1,4
dwight grant ,0,2,0,2,4
dylan andrews ,0,3,0,2,5
dylan budka,0,1,0,0,1
dylan budka ,0,1,0,0,1
ebenezer fontes braga ,0,0,0,1,1
ed herman,0,9,1,3,13
ed herman ,0,3,0,10,13
eddie alvarez,0,1,0,3,4
eddie alvarez ,0,2,1,1,4
eddie gordon,0,1,0,1,2
eddie gordon ,0,2,0,0,2
eddie mendez,0,1,0,0,1
eddie ruiz,0,1,0,0,1
eddie sanchez,0,3,0,0,3
eddie sanchez ,0,0,0,3,3
eddie wineland,0,4,0,2,6
eddie wineland ,0,6,0,4,10
eddie yagin,0,1,0,1,2
edgar chairez,0,1,0,0,1
edgar chairez ,0,1,1,1,3
edgar garcia,0,3,0,0,3
edgar garcia ,0,1,0,0,1
edilberto de oliveira,0,2,0,0,2
edimilson souza,0,0,0,1,1
edimilson souza ,0,1,0,2,3
edmen shahbazyan,0,2,0,2,4
edmen shahbazyan ,0,3,0,4,7
ednaldo oliveira,0,1,0,0,1
ednaldo oliveira ,0,1,0,0,1
edson barboza,0,3,0,7,10
edson barboza ,0,9,0,11,20
eduarda moura,0,0,0,1,1
eduarda moura ,0,1,0,1,2
eduardo garagorri,0,2,0,0,2
eduardo garagorri ,0,0,0,1,1
edward faaloloto,0,2,0,0,2
edwin dewees,0,3,0,0,3
edwin figueroa,0,3,0,1,4
edwin figueroa ,0,1,0,1,2
efrain escudero,0,4,0,0,4
efrain escudero ,0,3,0,5,8
eiji mitsuoka,0,2,0,0,2
eldo xavier dias,0,1,0,0,1
elias garcia,0,1,0,0,1
elias garcia ,0,1,0,0,1
elias silverio,0,1,0,2,3
elias silverio ,0,1,0,1,2
elias theodorou,0,2,0,1,3
elias theodorou ,0,1,0,7,8
eliot marshall,0,2,0,0,2
eliot marshall ,0,1,0,3,4
elise reed,0,3,0,3,6
elise reed ,0,1,0,1,2
elizabeth phillips,0,2,0,1,3
elizabeth phillips ,0,1,0,0,1
elizeu zaleski dos santos,1,2,0,3,6
elizeu zaleski dos santos ,0,2,0,8,10
elves brener,0,1,0,2,3
elves brener ,0,1,0,1,2
elvis mutapcic,1,1,0,0,2
elvis mutapcic ,0,1,0,0,1
elvis sinosic,0,6,0,0,6
elvis sinosic ,0,0,0,1,1
emil meek,0,2,0,1,3
emil meek ,0,1,0,0,1
emily ducote,0,2,0,2,4
emily ducote ,0,1,0,0,1
emily kagan,0,1,0,0,1
emily kagan ,0,1,0,0,1
emily whitmire,0,2,0,2,4
emily whitmire ,0,2,0,0,2
emmanuel yarborough,0,1,0,0,1
enrique barzola,1,0,0,3,4
enrique barzola ,0,3,0,3,6
enrique marin,0,2,0,0,2
enson inoue ,0,0,0,1,1
eric martin,0,1,0,0,1
eric schafer,0,5,0,0,5
eric schafer ,0,1,0,3,4
eric shelton,0,1,0,2,3
eric shelton ,0,3,0,0,3
eric spicely,0,2,0,1,3
eric spicely ,0,3,0,1,4
eric wisely,0,2,0,0,2
erick gonzalez,0,2,0,0,2
erick gonzalez ,0,1,0,0,1
erick montano ,0,2,0,1,3
erick silva,0,4,0,0,4
erick silva ,0,4,0,7,11
ericka almeida,0,2,0,0,2
erik koch,0,1,0,2,3
erik koch ,0,4,0,3,7
erik perez,0,1,0,3,4
erik perez ,0,1,0,4,5
erik silva,0,1,0,0,1
erik silva ,0,1,0,0,1
erin blanchfield,0,0,0,2,2
erin blanchfield ,0,1,0,4,5
ernest chavez,0,2,0,0,2
ernest chavez ,0,0,0,1,1
ernesta kareckaite,0,1,0,0,1
ernie verdicia,0,1,0,0,1
eryk anders,0,5,0,2,7
eryk anders ,0,3,1,7,11
esteban ribovics,0,0,0,3,3
esteban ribovics ,0,1,0,0,1
estevan payan,0,2,0,0,2
estevan payan ,0,1,0,0,1
eugene jackson,0,4,0,0,4
eugene jackson ,0,0,0,3,3
eugenio tadeu,0,1,0,0,1
evan dunham,1,7,0,4,12
evan dunham ,0,2,0,7,9
evan elder,0,2,0,0,2
evan elder ,0,0,0,2,2
evan tanner,0,6,0,0,6
evan tanner ,0,0,0,11,11
fabiano iha,0,4,0,0,4
fabiano iha ,0,0,0,3,3
fabiano scherner,0,2,0,0,2
fabio cherant,0,3,0,0,3
fabio gurgel,0,1,0,0,1
fabio maldonado,0,4,0,1,5
fabio maldonado ,0,2,0,4,6
fabricio camoes,1,3,0,0,4
fabricio camoes ,0,1,0,1,2
fabricio werdum,0,3,0,3,6
fabricio werdum ,0,3,0,9,12
falaniko vitale,0,1,0,0,1
falaniko vitale ,0,0,0,1,1
fares ziam,0,2,0,3,5
fares ziam ,0,0,0,3,3
farid basharat,0,0,0,1,1
farid basharat ,0,0,0,2,2
fatima kline,0,1,0,0,1
felice herrig,0,2,0,1,3
felice herrig ,0,3,0,4,7
felicia spencer,0,2,0,1,3
felicia spencer ,0,1,0,2,3
felipe arantes,0,2,0,2,4
felipe arantes ,1,4,0,3,8
felipe bunes,0,1,0,0,1
felipe colares,0,4,0,2,6
felipe dos santos,0,1,0,1,2
felipe dos santos ,0,1,0,0,1
felipe lima,0,0,0,2,2
felipe olivieri,0,1,0,0,1
felipe silva,0,2,0,1,3
felix lee mitchell,0,3,0,0,3
feng xiaocan,0,1,0,0,1
fernando bruno,0,2,0,0,2
fernando padilla,0,1,0,1,2
fernando padilla ,0,1,0,1,2
fernie garcia,0,2,0,0,2
fernie garcia ,0,1,0,0,1
filip pejic ,0,1,0,0,1
flavio luiz moura,0,1,0,0,1
floyd sword,0,1,0,0,1
forrest griffin,0,5,0,0,5
forrest griffin ,0,0,0,10,10
forrest petz,0,4,0,0,4
forrest petz ,0,1,0,2,3
francesco maturi,0,1,0,0,1
francimar barroso,0,2,0,2,4
francimar barroso ,0,2,1,2,5
francis carmont,0,1,0,3,4
francis carmont ,0,2,0,3,5
francis marshall,0,0,0,2,2
francis marshall ,0,2,0,0,2
francis ngannou,0,1,0,4,5
francis ngannou ,0,1,0,8,9
francisco figueiredo,0,1,0,1,2
francisco figueiredo ,0,1,0,1,2
francisco prado,0,2,0,1,3
francisco rivera,0,3,1,3,7
francisco rivera ,0,3,0,1,4
francisco trevino,0,0,0,1,1
francisco trevino ,0,2,0,0,2
francisco trinaldo,0,5,0,3,8
francisco trinaldo ,0,3,0,15,18
frank camacho,0,3,0,2,5
frank camacho ,0,3,0,0,3
frank caracci,0,1,0,0,1
frank hamaker ,0,0,0,1,1
frank lester,0,1,0,0,1
frank mir,0,7,0,1,8
frank mir ,0,4,0,15,19
frank shamrock ,0,0,0,5,5
frank trigg,0,5,0,0,5
frank trigg ,0,0,0,2,2
frankie edgar,0,6,0,2,8
frankie edgar ,1,5,0,16,22
frankie perez,0,1,0,1,2
frankie perez ,0,2,0,0,2
frankie saenz,0,2,0,3,5
frankie saenz ,0,3,0,2,5
fred ettish,0,1,0,0,1
fredson paixao ,0,1,0,0,1
fredy serrano,0,2,0,2,4
gabe green,0,3,0,0,3
gabe green ,0,0,0,2,2
gabe ruediger,0,3,0,0,3
gabriel benitez,0,1,0,1,2
gabriel benitez ,0,7,0,6,13
gabriel bonfim ,0,1,0,3,4
gabriel gonzaga,0,8,0,0,8
gabriel gonzaga ,0,2,0,12,14
gabriel miranda,0,2,0,1,3
gabriel santos,0,2,0,1,3
gabriel silva,0,1,0,0,1
gabriel silva ,0,1,0,0,1
gabriella fernandes,0,2,0,2,4
gadzhi omargadzhiev,0,2,0,0,2
gadzhimurad antigulov,0,1,0,2,3
gadzhimurad antigulov ,0,3,0,0,3
gaetano pirrello,0,2,0,0,2
galore bofando,0,1,0,1,2
gan mcgee,0,2,0,0,2
gan mcgee ,0,0,0,2,2
garett whiteley,0,3,0,0,3
garreth mclellan,0,2,0,1,3
garreth mclellan ,0,2,0,0,2
garrett armfield,0,3,0,1,4
gary goodridge,0,4,0,0,4
gary goodridge ,0,0,0,4,4
gasan umalatov,0,3,0,1,4
gaston bolanos,0,1,0,1,2
gaston bolanos ,0,0,0,1,1
gavin tucker,0,2,0,1,3
gavin tucker ,0,1,0,3,4
geane herrera,0,3,0,1,4
gegard mousasi,0,2,0,4,6
gegard mousasi ,0,1,0,5,6
genaro valdez,0,3,0,0,3
genki sudo,0,1,0,0,1
genki sudo ,0,0,0,2,2
geoff neal,0,2,0,2,4
geoff neal ,0,2,0,5,7
george roop,0,6,0,2,8
george roop ,0,2,0,3,5
george sotiropoulos ,0,4,0,7,11
george sullivan,0,2,0,1,3
george sullivan ,0,2,0,2,4
georges st-pierre,0,2,0,1,3
georges st-pierre ,0,0,0,19,19
gerald harris ,0,1,0,3,4
gerald meerschaert,0,7,0,8,15
gerald meerschaert ,0,3,0,4,7
gerald strebendt,0,1,0,0,1
geraldo de freitas ,0,2,0,1,3
germaine de randamie,0,3,0,4,7
germaine de randamie ,0,0,0,3,3
gerry harris,0,1,0,0,1
geza kalman,0,1,0,0,1
geza kalman ,0,0,0,1,1
gian villante,0,3,0,3,6
gian villante ,0,8,0,4,12
gideon ray,0,3,0,0,3
giga chikadze,0,2,0,2,4
giga chikadze ,0,0,0,5,5
gil castillo,0,2,0,0,2
gil castillo ,0,0,0,1,1
gilbert aldana,0,2,0,0,2
gilbert burns,0,3,0,6,9
gilbert burns ,0,5,0,9,14
gilbert melendez,0,4,0,0,4
gilbert melendez ,0,2,0,1,3
gilbert smith,0,1,0,0,1
gilbert urbina,0,1,0,1,2
gilbert urbina ,0,1,0,0,1
gilbert yvel,0,3,0,0,3
gillian robertson,0,4,0,5,9
gillian robertson ,0,2,0,7,9
gina mazany,0,3,0,1,4
gina mazany ,0,3,0,1,4
glaico franca moreira ,0,2,0,1,3
gleison tibau,0,8,0,4,12
gleison tibau ,0,4,0,12,16
gloria de paula,0,2,0,1,3
gloria de paula ,0,1,0,0,1
glover teixeira,0,3,0,5,8
glover teixeira ,0,4,0,11,15
godofredo pepey,0,3,0,0,3
godofredo pepey ,0,3,0,5,8
gokhan saki ,0,1,0,1,2
goran reljic,0,3,0,0,3
goran reljic ,0,0,0,1,1
grant dawson,0,0,0,4,4
grant dawson ,1,1,0,6,8
gray maynard,1,1,0,1,3
gray maynard ,0,6,1,10,17
greg hardy,0,4,0,1,5
greg hardy ,0,1,1,3,5
greg soto,0,2,0,1,3
greg stott,0,1,0,0,1
gregor gillespie,0,1,0,3,4
gregor gillespie ,0,0,0,4,4
gregory rodrigues,0,1,0,6,7
gregory rodrigues ,0,1,0,1,2
grigory popov,0,1,0,0,1
grigory popov ,0,1,0,0,1
guangyou ning,0,1,0,0,1
guangyou ning ,0,1,0,2,3
guido cannetti,0,5,0,3,8
guido cannetti ,0,1,0,1,2
guilherme vasconcelos,0,1,0,0,1
gunnar nelson,0,2,0,3,5
gunnar nelson ,0,3,0,7,10
guram kutateladze,0,1,0,1,2
guram kutateladze ,0,1,0,1,2
gustavo lopez,0,2,0,0,2
gustavo lopez ,1,0,0,1,2
guto inocente,0,2,0,0,2
guy mezger,0,1,0,0,1
guy mezger ,0,0,0,4,4
hacran dias,0,2,0,2,4
hacran dias ,0,3,0,1,4
hailey cowan ,0,1,0,0,1
hakeem dawodu,0,3,0,1,4
hakeem dawodu ,0,1,0,5,6
hamdy abdelwahab,0,0,0,1,1
hannah cifers,0,4,0,1,5
hannah cifers ,0,1,0,1,2
hannah goldy,0,4,0,1,5
hans stringer,0,2,0,1,3
harold howard,0,2,0,0,2
harold howard ,0,0,0,1,1
harry hunsucker,0,3,0,0,3
harry moskowitz,0,2,0,0,2
hatsu hioki,0,2,0,0,2
hatsu hioki ,0,3,0,3,6
hayato sakurai,0,1,0,0,1
hayder hassan,0,1,0,0,1
hayder hassan ,0,1,0,0,1
he-man gipson,0,1,0,0,1
heath herring,0,3,0,0,3
heath herring ,0,0,0,2,2
heather clark,0,2,0,1,3
hector aldana,0,3,0,0,3
hector lombard,0,5,0,2,7
hector lombard ,0,3,1,1,5
hector ramirez,0,2,0,0,2
hector sandoval,0,2,0,0,2
hector sandoval ,0,0,0,2,2
hector urbina,0,1,0,1,2
hector urbina ,0,1,0,0,1
henrique da silva,0,2,0,1,3
henrique da silva ,0,2,0,1,3
henry briones,0,1,0,0,1
henry briones ,0,3,0,1,4
henry cejudo,0,4,0,3,7
henry cejudo ,0,0,0,7,7
henry martinez,0,2,0,0,2
henry martinez ,0,0,0,1,1
herbert burns,0,3,0,1,4
herbert burns ,0,1,0,1,2
hermes franca,0,5,0,0,5
hermes franca ,0,0,0,6,6
hernani perpetuo,0,1,0,0,1
hernani perpetuo ,0,1,0,0,1
holly holm,0,2,0,2,4
holly holm ,0,6,0,6,12
homer moore,0,1,0,0,1
horacio gutierrez,0,1,0,0,1
horacio gutierrez ,0,1,0,0,1
houston alexander,0,4,0,0,4
houston alexander ,0,0,0,2,2
houston dorr,0,1,0,0,1
hu yaozong,0,1,0,0,1
hu yaozong ,0,2,0,0,2
hugo duarte,0,1,0,0,1
hugo viana,0,1,0,3,4
hugo viana ,0,2,0,0,2
humberto bandenay,0,2,0,1,3
humberto bandenay ,0,1,0,0,1
humberto brown morrison,0,1,0,0,1
hunter azure,0,0,0,2,2
hunter azure ,0,2,0,0,2
hyder amil,0,0,0,2,2
hyun gyu lim,0,2,0,2,4
hyun gyu lim ,0,2,0,1,3
hyunsung park,0,0,0,1,1
hyunsung park ,0,0,0,1,1
ian entwistle,0,1,0,1,2
ian entwistle ,0,1,0,0,1
ian freeman,1,2,0,0,3
ian freeman ,0,0,0,3,3
ian garry,0,0,0,2,2
ian garry ,0,0,0,4,4
ian heinisch,0,3,0,2,5
ian heinisch ,0,1,0,1,2
ian loveland,0,2,0,0,2
ian loveland ,0,0,0,1,1
ian machado garry,0,1,0,1,2
ian machado garry ,0,0,0,1,1
ian mccall,1,2,0,1,4
ian mccall ,0,1,0,1,2
iasmin lucindo,0,1,0,3,4
iasmin lucindo ,0,0,0,1,1
ibo aslan ,0,0,0,1,1
icho larenas,0,1,0,0,1
ignacio bahamondes,0,1,0,3,4
ignacio bahamondes ,0,1,0,2,3
igor araujo,0,0,0,1,1
igor araujo ,0,2,0,1,3
igor pokrajac,0,6,0,2,8
igor pokrajac ,0,2,1,2,5
igor severino ,0,1,0,0,1
igor zinoviev,0,1,0,0,1
ihor potieria,0,5,0,2,7
ike villanueva,0,4,0,0,4
ike villanueva ,0,1,0,1,2
ikram aliskerov,0,1,0,1,2
ikuhisa minowa ,0,0,0,1,1
ildemar alcantara,0,2,0,2,4
ildemar alcantara ,0,1,0,2,3
ilia topuria,0,0,0,6,6
ilia topuria ,0,0,0,1,1
iliarde santos,0,2,0,0,2
iliarde santos ,0,1,0,0,1
ilir latifi,0,4,0,4,8
ilir latifi ,0,3,0,5,8
impa kasanganay,0,0,0,1,1
impa kasanganay ,0,2,0,1,3
inoue mizuki,0,1,0,1,2
ion cutelaba,0,6,0,3,9
ion cutelaba ,1,3,0,4,8
irene aldana,0,5,0,2,7
irene aldana ,0,1,0,6,7
irina alekseeva,0,0,0,1,1
irina alekseeva ,0,1,0,0,1
irwin rivera,0,2,0,0,2
irwin rivera ,0,0,0,1,1
isaac dulgarian,0,1,0,1,2
isaac dulgarian ,0,0,0,1,1
isaac vallie-flagg,0,2,0,1,3
isaac vallie-flagg ,0,1,0,0,1
isabela de padua,0,1,0,0,1
islam makhachev,0,1,0,4,5
islam makhachev ,0,0,0,10,10
ismael bonfim ,0,1,0,2,3
ismail naurdiev,0,1,0,2,3
ismail naurdiev ,0,1,0,0,1
israel adesanya,0,2,0,6,8
israel adesanya ,0,2,0,7,9
issei tamura,0,2,0,1,3
istela nunes,0,2,0,0,2
istela nunes ,0,2,0,0,2
iuri alcantara,0,3,0,2,5
iuri alcantara ,0,4,1,8,13
ivan erslan,0,1,0,0,1
ivan jorge,0,2,0,1,3
ivan jorge ,0,0,0,1,1
ivan menjivar,0,3,0,0,3
ivan menjivar ,0,2,0,4,6
ivan salaverry,0,4,0,0,4
ivan salaverry ,0,0,0,3,3
ivan serati,0,1,0,0,1
ivana petrovic,0,1,0,0,1
ivana petrovic ,0,1,0,1,2
izabela badurek ,0,1,0,0,1
jacare souza,0,2,0,2,4
jacare souza ,0,5,0,7,12
jack della maddalena,0,0,0,2,2
jack della maddalena ,0,0,0,5,5
jack hermansson,0,2,0,6,8
jack hermansson ,0,4,0,5,9
jack jenkins,0,0,0,1,1
jack jenkins ,0,1,0,2,3
jack marshman,0,4,0,1,5
jack marshman ,0,1,0,2,3
jack may,0,2,0,0,2
jack mcglaughlin,0,1,0,0,1
jack nilson,0,1,0,0,1
jack nilson ,0,0,0,1,1
jack shore,0,1,0,1,2
jack shore ,0,2,0,5,7
jackie lee,0,1,0,0,1
jacob kilburn,0,1,0,0,1
jacob kilburn ,0,1,0,0,1
jacob malkoun,0,1,0,4,5
jacob malkoun ,0,2,0,0,2
jacob volkmann,0,2,0,1,3
jacob volkmann ,0,2,0,5,7
jacqueline cavalcanti,0,0,0,2,2
jacqueline cavalcanti ,0,0,0,1,1
jafel filho,0,1,0,0,1
jafel filho ,0,0,0,2,2
jai herbert,0,2,0,1,3
jai herbert ,1,2,0,2,5
jailton almeida,0,1,0,2,3
jailton almeida ,0,0,0,5,5
jairzinho rozenstruik,0,3,0,6,9
jairzinho rozenstruik ,0,2,0,3,5
jake collier,0,8,0,2,10
jake collier ,0,1,0,3,4
jake ellenberger,0,4,0,4,8
jake ellenberger ,0,7,0,6,13
jake hadley,0,2,0,1,3
jake hadley ,0,2,0,2,4
jake hecht,0,1,0,1,2
jake hecht ,0,1,0,0,1
jake lindsey,0,2,0,0,2
jake lindsey ,0,1,0,0,1
jake matthews,0,2,0,4,6
jake matthews ,0,5,0,9,14
jake o'brien,0,3,0,0,3
jake o'brien ,0,0,0,4,4
jake rosholt,0,2,0,0,2
jake rosholt ,0,0,0,1,1
jake shields,0,1,0,2,3
jake shields ,0,2,1,2,5
jalin turner,0,2,0,4,6
jalin turner ,0,3,0,3,6
jamahal hill,0,2,0,5,7
jamahal hill ,0,0,1,1,2
jamal pogues,0,1,0,2,3
jamall emmers,0,2,0,1,3
jamall emmers ,0,2,0,2,4
james bochnovic,0,2,0,0,2
james giboo,0,1,0,0,1
james hammortree,0,1,0,0,1
james head,0,2,0,2,4
james head ,0,1,0,0,1
james irvin,0,5,0,0,5
james irvin ,0,1,0,4,5
james krause,0,3,0,5,8
james krause ,0,1,0,4,5
james lee,0,1,0,0,1
james llontop,0,2,0,0,2
james llontop ,0,1,0,0,1
james mcsweeney ,0,2,0,1,3
james moontasri,0,3,0,0,3
james moontasri ,0,1,0,2,3
james mulheron ,0,1,0,0,1
james te huna,0,3,0,0,3
james te huna ,0,2,0,5,7
james toney,0,1,0,0,1
james vick,0,3,0,4,7
james vick ,0,2,0,5,7
james wilks,0,1,0,0,1
james wilks ,0,1,0,2,3
james zikic,0,1,0,0,1
jamey simmons,0,2,0,0,2
jamey-lyn horth,0,2,0,1,3
jamey-lyn horth ,0,0,0,1,1
jamie moyle,0,1,0,1,2
jamie moyle ,0,1,0,0,1
jamie mullarkey,0,4,0,2,6
jamie mullarkey ,0,2,0,3,5
jamie pickett,0,7,0,0,7
jamie pickett ,0,0,0,2,2
jamie varner,0,2,0,2,4
jamie varner ,0,4,0,1,5
jamie yager ,0,1,0,0,1
jan blachowicz,0,3,0,6,9
jan blachowicz ,1,4,0,6,11
jaqueline amorim ,0,1,0,3,4
jared cannonier,0,4,0,4,8
jared cannonier ,0,4,0,6,10
jared gooden,0,4,0,2,6
jared gooden ,0,1,0,0,1
jared gordon,0,3,1,3,7
jared gordon ,0,3,0,5,8
jared hamman,0,1,0,2,3
jared hamman ,0,4,0,0,4
jared papazian,0,2,0,0,2
jared papazian ,0,1,0,0,1
jared rollins,0,1,0,0,1
jared rosholt,0,1,0,2,3
jared rosholt ,0,1,0,4,5
jared vanderaa,0,5,0,1,6
jared vanderaa ,0,1,0,0,1
jarjis danho,0,1,0,1,2
jarjis danho ,1,0,0,0,1
jarno errens,0,2,0,0,2
jarno errens ,0,0,0,1,1
jarred brooks,0,1,0,2,3
jarred brooks ,0,1,0,0,1
jasmine jasudavicius,0,1,0,3,4
jasmine jasudavicius ,0,1,0,3,4
jason black,0,2,0,0,2
jason brilz,0,3,0,1,4
jason brilz ,0,1,0,2,3
jason day,0,2,0,0,2
jason day ,0,0,0,1,1
jason delucia,0,2,0,0,2
jason delucia ,0,0,0,1,1
jason dent,0,3,0,0,3
jason dent ,0,0,0,1,1
jason fairn,0,1,0,0,1
jason gilliam,0,2,0,0,2
jason godsey,0,2,0,0,2
jason gonzalez,0,3,0,0,3
jason gonzalez ,0,0,0,1,1
jason high,0,3,0,1,4
jason high ,0,0,0,1,1
jason knight,0,2,0,4,6
jason knight ,0,3,0,0,3
jason lambert,0,4,0,0,4
jason lambert ,0,0,0,4,4
jason macdonald,0,6,0,0,6
jason macdonald ,0,2,0,6,8
jason miller,0,2,0,0,2
jason miller ,0,1,0,0,1
jason novelli,0,2,0,0,2
jason reinhardt,0,3,0,0,3
jason saggo ,0,3,0,3,6
jason tan,0,2,0,0,2
jason thacker,0,1,0,0,1
jason von flue,0,2,0,0,2
jason von flue ,0,0,0,1,1
jason witt,0,2,0,2,4
jason witt ,0,2,0,0,2
jason young,0,2,0,0,2
jason young ,0,1,0,1,2
javid basharat,0,1,0,2,3
javid basharat ,0,0,0,1,1
javier vazquez,0,0,0,1,1
jay cucciniello ,0,1,0,0,1
jay hieron,0,4,0,0,4
jay perrin,0,3,0,0,3
jay silva,0,2,0,0,2
jc cottrell,0,2,0,0,2
jean matsumoto,0,0,0,2,2
jean silva,0,0,0,3,3
jeff cox,0,2,0,0,2
jeff curran,0,2,0,0,2
jeff curran ,0,1,0,0,1
jeff hougland,0,2,0,0,2
jeff hougland ,0,0,0,1,1
jeff hughes,0,3,1,0,4
jeff joslin,0,1,0,0,1
jeff molina,0,0,0,1,1
jeff molina ,0,0,0,2,2
jeff monson,0,3,0,0,3
jeff monson ,0,0,0,4,4
jeff newton,0,1,0,0,1
jeka saragih ,0,2,0,1,3
jenel lausa,0,0,0,1,1
jenel lausa ,0,3,0,0,3
jennifer maia,0,4,0,3,7
jennifer maia ,0,2,0,3,5
jens pulver,0,2,0,0,2
jens pulver ,1,0,0,6,7
jeongyeong lee ,0,1,0,2,3
jeremiah wells,0,1,0,2,3
jeremiah wells ,0,1,0,2,3
jeremy horn,0,7,0,0,7
jeremy horn ,0,0,0,6,6
jeremy jackson,0,2,0,0,2
jeremy kennedy,0,1,0,2,3
jeremy kennedy ,0,0,0,1,1
jeremy kimball,0,1,0,1,2
jeremy kimball ,0,2,0,0,2
jeremy larsen,0,2,0,0,2
jeremy larsen ,0,1,0,0,1
jeremy stephens,0,13,1,7,21
jeremy stephens ,0,5,0,8,13
jermaine andre,0,1,0,0,1
jerome rivera,0,4,0,0,4
jerrod sanders,0,2,1,1,4
jerry bohlander,0,2,0,0,2
jerry bohlander ,0,0,0,5,5
jess liaudin,0,3,0,0,3
jess liaudin ,0,0,0,2,2
jessamyn duke ,0,3,0,1,4
jesse bongfeldt ,1,1,0,0,2
jesse butler,0,2,0,0,2
jesse forbes,0,2,0,0,2
jesse forbes ,0,1,0,0,1
jesse lennox,0,2,0,0,2
jesse lennox ,0,0,0,1,1
jesse ronson,0,4,1,0,5
jesse ronson ,0,1,0,0,1
jesse sanders,0,1,0,0,1
jesse strader,0,2,0,0,2
jesse taylor,0,1,0,1,2
jessica aguilar,0,3,0,0,3
jessica aguilar ,0,1,0,1,2
jessica andrade,0,3,0,8,11
jessica andrade ,0,8,0,9,17
jessica eye,0,5,1,3,9
jessica eye ,0,5,0,2,7
jessica penne,0,1,0,1,2
jessica penne ,0,5,0,2,7
jessica rakoczy,0,1,0,0,1
jessica rakoczy ,0,1,0,0,1
jessica-rose clark,0,0,0,2,2
jessica-rose clark ,0,5,0,2,7
jessin ayari,0,3,0,0,3
jessin ayari ,0,0,0,1,1
jesus aguilar,0,1,0,2,3
jesus aguilar ,0,0,0,1,1
jesus pinedo,0,1,0,1,2
jhonata diniz,0,1,0,1,2
jhonata diniz ,0,0,0,1,1
ji yeon kim,0,2,0,2,4
ji yeon kim ,0,5,0,1,6
jianping yang,0,1,0,0,1
jim alers,0,1,1,1,3
jim alers ,0,1,0,0,1
jim miller,0,8,0,2,10
jim miller ,0,9,1,25,35
jim mullen,0,1,0,0,1
jim wallhead,0,2,0,0,2
jimi manuwa,0,2,0,2,4
jimi manuwa ,0,4,0,4,8
jimmie rivera,0,1,0,4,5
jimmie rivera ,0,3,0,3,6
jimmy crute,0,2,0,0,2
jimmy crute ,1,2,0,4,7
jimmy flick,0,1,0,1,2
jimmy flick ,0,2,0,1,3
jimmy quinlan,0,1,0,0,1
jimy hettes,0,2,0,1,3
jimy hettes ,0,1,0,2,3
jin soo son,0,2,0,0,2
jinh yu frey,0,5,0,1,6
jinh yu frey ,0,0,0,1,1
jiri prochazka,0,1,0,3,4
jiri prochazka ,0,1,0,1,2
jj aldrich,0,5,0,4,9
jj aldrich ,0,1,0,4,5
joachim christensen,0,1,0,1,2
joachim christensen ,0,2,0,0,2
joanderson brito,0,2,0,3,5
joanderson brito ,0,0,0,2,2
joanna jedrzejczyk,0,4,0,3,7
joanna jedrzejczyk ,0,1,0,7,8
joanne wood,0,3,0,2,5
joanne wood ,0,5,0,7,12
joao pierini,0,1,0,0,1
joao roque,0,1,0,0,1
joao zeferino,0,1,0,0,1
joao zeferino ,0,1,0,0,1
joaquim silva,0,2,0,3,5
joaquim silva ,0,3,0,3,6
joaquin buckley,0,3,0,6,9
joaquin buckley ,0,1,0,5,6
joby sanchez,0,3,0,1,4
joby sanchez ,0,1,0,0,1
jocelyn jones-lybarger,0,2,0,0,2
jocelyn jones-lybarger ,0,1,0,0,1
jodie esquibel,0,4,0,0,4
joe brammer,0,2,0,0,2
joe charles,0,2,0,0,2
joe charles ,0,0,0,2,2
joe doerksen,0,6,0,1,7
joe doerksen ,0,1,0,1,2
joe duffy,0,3,0,1,4
joe duffy ,0,1,0,3,4
joe ellenberger ,0,1,0,1,2
joe giannetti,0,1,0,0,1
joe jordan,0,1,0,0,1
joe lauzon,0,5,0,2,7
joe lauzon ,0,7,0,13,20
joe merritt,0,1,0,0,1
joe moreira,0,1,0,0,1
joe moreira ,0,0,0,1,1
joe pardo,0,1,0,0,1
joe proctor,0,2,0,2,4
joe proctor ,0,2,0,2,4
joe pyfer,0,1,0,1,2
joe pyfer ,0,0,0,3,3
joe riggs,0,6,0,0,6
joe riggs ,0,1,0,5,6
joe slick,0,1,0,0,1
joe slick ,0,0,0,1,1
joe solecki,0,2,0,2,4
joe solecki ,0,1,0,3,4
joe son,0,1,0,0,1
joe soto,0,2,0,3,5
joe soto ,0,3,0,0,3
joe stevenson,0,5,0,0,5
joe stevenson ,0,3,0,8,11
joe vedepo,0,2,0,0,2
joe veres,0,2,0,0,2
joel alvarez,0,2,0,3,5
joel alvarez ,0,0,0,4,4
joel sutton ,0,0,0,2,2
joey beltran,0,4,1,0,5
joey beltran ,0,2,0,3,5
joey gambino,0,2,0,0,2
joey gilbert,0,1,0,0,1
joey gomez,0,2,0,0,2
joey roberts,0,1,0,0,1
john albert,0,2,0,1,3
john albert ,0,2,0,0,2
john alessio,0,4,0,0,4
john alessio ,0,1,0,0,1
john allan,0,2,1,0,3
john campetella,0,1,0,0,1
john castaneda,0,1,0,2,3
john castaneda ,0,2,0,2,4
john cholish,0,2,0,1,3
john cofer,0,2,0,0,2
john dodson,0,4,0,1,5
john dodson ,0,3,0,9,12
john dowdy,0,1,0,0,1
john gunderson,0,2,0,0,2
john gunderson ,0,0,0,1,1
john gunther,0,1,0,0,1
john gunther ,0,0,0,1,1
john halverson,0,2,0,0,2
john hathaway,0,1,0,1,2
john hathaway ,0,1,0,6,7
john howard,0,3,0,2,5
john howard ,0,4,0,5,9
john kolosci,0,1,0,0,1
john lewis,0,1,0,0,1
john lewis ,0,0,0,1,1
john lineker,0,2,0,5,7
john lineker ,0,2,0,7,9
john lober,0,1,0,0,1
john maguire,0,3,0,1,4
john maguire ,0,0,0,1,1
john makdessi,0,3,0,2,5
john makdessi ,0,6,0,9,15
john marsh,0,1,0,0,1
john matua,0,1,0,0,1
john moraga,0,3,0,2,5
john moraga ,0,3,0,6,9
john phillips,0,3,0,1,4
john phillips ,0,2,0,0,2
john polakowski,0,1,0,0,1
john salter,0,2,0,1,3
john teixeira ,0,1,0,0,1
johnny bedford,0,2,1,1,4
johnny bedford ,0,1,0,1,2
johnny case,0,2,0,3,5
johnny case ,0,0,0,1,1
johnny eduardo,0,3,0,2,5
johnny eduardo ,0,2,0,1,3
johnny munoz,0,2,0,1,3
johnny munoz ,0,2,0,1,3
johnny rees,0,2,0,0,2
johnny rhodes,0,1,0,0,1
johnny rhodes ,0,0,0,2,2
johnny walker,0,3,0,4,7
johnny walker ,0,3,0,3,6
johny hendricks,0,2,0,4,6
johny hendricks ,0,6,0,9,15
jon delos reyes,0,3,0,1,4
jon fitch,1,1,0,1,3
jon fitch ,0,2,0,13,15
jon hess ,0,0,0,1,1
jon jones,0,1,1,2,4
jon jones ,0,0,0,20,20
jon madsen ,0,1,0,4,5
jon manley ,0,1,0,0,1
jon olav einemo,0,2,0,0,2
jon tuck,0,3,0,3,6
jon tuck ,0,2,0,1,3
jonathan brookins,0,1,0,0,1
jonathan brookins ,0,2,0,2,4
jonathan goulet,0,5,0,0,5
jonathan goulet ,0,0,0,4,4
jonathan martinez,0,3,0,7,10
jonathan martinez ,0,2,0,3,5
jonathan meunier,0,1,0,1,2
jonathan pearce,0,1,0,2,3
jonathan pearce ,0,3,0,3,6
jonathan wiezorek ,0,0,0,1,1
jonathan wilson,0,1,0,1,2
jonathan wilson ,0,2,0,0,2
jonavin webb,0,1,0,0,1
jonavin webb ,0,1,0,0,1
jonny parsons,0,0,0,1,1
jordan espinosa,0,1,0,1,2
jordan espinosa ,0,3,0,1,4
jordan griffin,0,3,0,0,3
jordan griffin ,0,1,0,1,2
jordan johnson,0,0,0,2,2
jordan johnson ,0,0,0,2,2
jordan leavitt,0,3,0,1,4
jordan leavitt ,0,0,0,3,3
jordan mein,0,1,0,2,3
jordan mein ,0,3,0,3,6
jordan radev,0,2,0,0,2
jordan rinaldi,0,2,0,2,4
jordan rinaldi ,0,1,0,0,1
jordan vucenic,0,1,0,0,1
jordan williams,0,2,0,0,2
jordan williams ,0,1,0,0,1
jordan wright,0,1,0,1,2
jordan wright ,0,4,0,1,5
jorge de oliveira,0,1,0,0,1
jorge de oliveira ,0,1,0,0,1
jorge gurgel,0,4,0,0,4
jorge gurgel ,0,0,0,3,3
jorge lopez,0,2,0,0,2
jorge masvidal,0,7,0,7,14
jorge masvidal ,0,3,0,5,8
jorge patino,0,1,0,0,1
jorge rivera,0,6,0,1,7
jorge rivera ,0,1,0,7,8
jorge santiago,0,5,0,0,5
jorge santiago ,0,0,0,1,1
jose aldo,0,3,0,1,4
jose aldo ,0,5,0,13,18
jose daniel medina,0,1,0,0,1
jose johnson,0,2,0,1,3
jose maria,0,1,0,0,1
jose maria ,0,1,0,0,1
jose ochoa,0,1,0,0,1
jose quinonez,0,4,0,1,5
jose quinonez ,0,0,0,4,4
jose torres,0,1,0,1,2
josefine knutsson ,0,1,0,2,3
joselyne edwards,0,4,0,2,6
joselyne edwards ,0,0,0,3,3
joseph benavidez,0,2,0,1,3
joseph benavidez ,0,4,0,14,18
joseph gigliotti,0,1,0,0,1
joseph gigliotti ,0,1,0,0,1
joseph holmes,0,1,0,0,1
joseph holmes ,0,2,0,1,3
joseph morales,0,1,0,0,1
joseph morales ,0,1,0,1,2
joseph sandoval,0,1,0,0,1
joseph sandoval ,0,1,0,0,1
josh barnett,0,1,0,2,3
josh barnett ,0,2,0,5,7
josh bryant ,0,1,0,0,1
josh clopton,0,2,0,0,2
josh copeland,0,2,0,0,2
josh culibao,1,2,0,1,4
josh culibao ,0,2,0,2,4
josh emmett,0,1,0,4,5
josh emmett ,0,3,0,6,9
josh ferguson,0,2,0,0,2
josh fremd,0,2,0,1,3
josh fremd ,0,2,0,1,3
josh grispi,0,2,0,0,2
josh grispi ,0,2,0,0,2
josh haynes,0,3,0,0,3
josh hendricks,0,1,0,0,1
josh koscheck,0,7,0,1,8
josh koscheck ,0,3,0,14,17
josh neer,0,8,0,1,9
josh neer ,0,1,0,5,6
josh parisian,0,2,0,0,2
josh parisian ,0,3,0,2,5
josh quinlan,0,0,0,1,1
josh quinlan ,0,3,0,0,3
josh rafferty,0,1,0,0,1
josh samman,0,1,0,1,2
josh samman ,0,1,0,2,3
josh sampo,0,3,0,0,3
josh sampo ,0,0,0,1,1
josh shockley,0,2,0,0,2
josh shockman,0,1,0,0,1
josh stansbury,0,0,0,1,1
josh stansbury ,0,2,0,0,2
josh stuart,0,1,0,0,1
josh thomson,0,2,0,1,3
josh thomson ,0,2,0,2,4
joshua burkman,0,8,1,0,9
joshua burkman ,0,4,0,6,10
joshua van,0,0,0,3,3
joshua van ,0,1,0,2,3
joshua weems,0,1,0,0,1
josiane nunes,0,1,0,1,2
josiane nunes ,0,1,0,2,3
journey newson,0,2,1,0,3
journey newson ,0,2,0,1,3
jp buys,0,2,0,0,2
jp buys ,0,2,0,0,2
juan adams,0,2,0,1,3
juan adams ,0,1,0,0,1
juan espino,0,1,0,0,1
juan espino ,0,0,0,2,2
juan manuel puig,0,1,0,0,1
juan manuel puig ,0,1,0,0,1
juancamilo ronderos,0,2,0,0,2
jules bruchez,0,1,0,0,1
julia avila,0,1,0,0,1
julia avila ,0,1,0,3,4
julia polastri,0,1,0,0,1
julia polastri ,0,0,0,1,1
julian erosa,0,4,0,4,8
julian erosa ,0,3,0,4,7
julian marquez,0,1,0,2,3
julian marquez ,0,3,0,1,4
julian sanchez,0,1,0,0,1
juliana lima,0,3,0,0,3
juliana lima ,0,1,0,3,4
juliana miller,0,0,0,1,1
juliana miller ,0,2,0,0,2
julianna pena,0,2,0,4,6
julianna pena ,0,1,0,4,5
julie kedzie ,0,2,0,0,2
julija stoliarenko,0,4,0,2,6
julija stoliarenko ,0,2,0,0,2
julio arce,0,1,0,1,2
julio arce ,0,3,0,5,8
julio paulino,0,2,0,0,2
jumabieke tuerxun ,0,3,0,0,3
junie browning,0,1,0,0,1
junie browning ,0,0,0,1,1
junior albini,0,2,0,1,3
junior albini ,0,2,0,0,2
junior assuncao,0,3,0,0,3
junior assuncao ,0,0,0,2,2
junior dos santos,0,4,0,5,9
junior dos santos ,0,4,0,10,14
junior tafa,0,2,0,0,2
junior tafa ,0,1,0,1,2
junyong park,0,0,0,4,4
junyong park ,0,3,0,4,7
jussier formiga,0,2,0,1,3
jussier formiga ,0,5,0,8,13
justin buchholz,0,4,0,0,4
justin buchholz ,0,0,0,1,1
justin edwards,0,4,0,1,5
justin edwards ,0,1,0,1,2
justin eilers,0,3,0,0,3
justin eilers ,0,0,0,1,1
justin frazier,0,1,0,0,1
justin gaethje,0,4,0,5,9
justin gaethje ,0,1,0,3,4
justin james,0,1,0,0,1
justin jaynes,0,4,0,1,5
justin jones,0,2,0,0,2
justin lawrence ,0,2,0,1,3
justin ledet,0,3,0,1,4
justin ledet ,0,1,0,2,3
justin levens,0,2,0,0,2
justin martin ,0,0,0,1,1
justin mccully,0,2,0,0,2
justin mccully ,0,0,0,2,2
justin salas,0,3,0,2,5
justin salas ,0,1,0,1,2
justin scoggins,0,2,0,3,5
justin scoggins ,0,3,0,1,4
justin tafa,0,2,1,1,4
justin tafa ,0,2,0,3,5
justin willis,0,1,0,2,3
justin willis ,0,0,0,2,2
justin wren,0,1,0,0,1
justine kish,0,3,0,0,3
justine kish ,0,1,0,3,4
jutaro nakao,0,1,0,0,1
jutaro nakao ,0,0,0,1,1
kaan ofli ,0,1,0,0,1
kai asakura,0,1,0,0,1
kai kamaka,1,1,0,0,2
kai kamaka ,0,1,0,1,2
kai kara-france,0,2,0,3,5
kai kara-france ,0,2,0,5,7
kailin curran,0,3,0,0,3
kailin curran ,0,3,0,1,4
kajan johnson,0,1,0,3,4
kajan johnson ,0,2,0,1,3
kalib starnes,0,3,0,0,3
kalib starnes ,0,0,0,2,2
kalindra faria,0,2,0,0,2
kalindra faria ,0,1,0,0,1
kamal shalorus,0,2,0,0,2
kamal shalorus ,0,1,0,0,1
kamaru usman,0,1,0,4,5
kamaru usman ,0,1,0,11,12
kamuela kirk,0,1,0,1,2
kamuela kirk ,0,1,0,0,1
kanako murata,0,1,0,1,2
kanako murata ,0,1,0,0,1
karine gevorgyan ,0,1,0,0,1
karine silva,0,1,0,1,2
karine silva ,0,0,0,3,3
karl roberson,0,4,0,2,6
karl roberson ,0,2,0,2,4
karl williams,0,1,0,0,1
karl williams ,0,0,0,3,3
karlos vemola,0,3,0,2,5
karlos vemola ,0,1,0,0,1
karo parisyan,0,3,0,0,3
karo parisyan ,0,1,1,8,10
karol rosa,0,2,0,2,4
karol rosa ,0,1,0,5,6
karolina kowalkiewicz,0,3,0,3,6
karolina kowalkiewicz ,0,6,0,6,12
katlyn cerminara ,0,1,0,0,1
katlyn chookagian,0,2,0,2,4
katlyn chookagian ,0,3,0,9,12
katsuhisa fujii,0,1,0,0,1
katsuhisa fujii ,0,0,0,1,1
katsunori kikuno,0,2,0,0,2
katsunori kikuno ,0,1,0,2,3
kaue fernandes,0,0,0,1,1
kaue fernandes ,0,1,0,0,1
kay hansen,0,1,0,0,1
kay hansen ,0,2,0,1,3
kayla harrison,0,0,0,2,2
kaynan kruschewsky,0,2,0,0,2
kazuhiro nakamura,0,2,0,0,2
kazuki tokudome,0,1,0,1,2
kazuki tokudome ,0,2,0,0,2
kazula vargas,0,2,0,0,2
kazula vargas ,0,1,0,1,2
kazushi sakuraba ,0,0,1,1,2
kb bhullar,0,2,0,0,2
keigo kunihara,0,1,0,0,1
keiichiro yamamiya,0,1,0,0,1
keita nakamura,0,6,0,1,7
keita nakamura ,0,1,0,3,4
keith berish,0,0,1,0,1
keith berish ,0,1,0,0,1
keith hackney,0,2,0,0,2
keith hackney ,0,0,0,2,2
keith jardine,0,6,0,0,6
keith jardine ,0,1,0,6,7
keith mielke,0,1,0,0,1
keith rockel,0,1,0,0,1
keith rockel ,0,0,0,1,1
keith wisniewski,0,2,0,0,2
keith wisniewski ,0,2,0,0,2
kelly dullanty,0,1,0,0,1
kelly faszholz,0,1,0,0,1
kelly faszholz ,0,1,0,0,1
kelvin gastelum,0,7,1,7,15
kelvin gastelum ,0,2,0,6,8
ken shamrock,0,4,0,0,4
ken shamrock ,0,0,0,4,4
ken stone,0,1,0,0,1
ken stone ,0,1,0,2,3
kendall grove,0,3,0,0,3
kendall grove ,0,3,0,7,10
kenichi yamamoto,0,1,0,0,1
kenichi yamamoto ,0,0,0,2,2
kennedy nzechukwu,0,3,0,1,4
kennedy nzechukwu ,0,2,0,6,8
kenny florian,0,4,0,0,4
kenny florian ,0,1,0,12,13
kenny robertson,0,4,0,1,5
kenny robertson ,0,1,0,3,4
kerry schall,0,1,0,0,1
ketlen souza,0,1,0,2,3
ketlen vieira,0,0,0,5,5
ketlen vieira ,0,4,0,3,7
kevin aguilar,0,2,0,2,4
kevin aguilar ,0,2,0,0,2
kevin borjas,0,2,0,0,2
kevin burns,0,3,0,0,3
kevin burns ,0,0,0,2,2
kevin casey,0,3,1,0,4
kevin casey ,1,0,1,1,3
kevin croom,0,3,1,0,4
kevin ferguson ,0,1,0,1,2
kevin holland,0,7,0,3,10
kevin holland ,0,2,1,10,13
kevin jackson,0,2,0,0,2
kevin jackson ,0,0,0,2,2
kevin jordan,0,2,0,0,2
kevin jousset,0,0,0,1,1
kevin jousset ,0,1,0,1,2
kevin lee,0,4,0,8,12
kevin lee ,0,4,0,3,7
kevin natividad,0,3,0,0,3
kevin randleman,0,3,0,0,3
kevin randleman ,0,0,0,4,4
kevin rosier,0,1,0,0,1
khabib nurmagomedov,0,0,0,5,5
khabib nurmagomedov ,0,0,0,8,8
khadis ibragimov,0,2,0,0,2
khadis ibragimov ,0,2,0,0,2
khalid murtazaliev ,0,0,0,1,1
khalid taha,0,1,0,1,2
khalid taha ,0,3,1,0,4
khalil rountree jr.,0,3,0,6,9
khalil rountree jr. ,0,3,1,3,7
khama worthy,0,2,0,2,4
khama worthy ,0,1,0,0,1
khamzat chimaev,0,0,0,3,3
khamzat chimaev ,0,0,0,3,3
khaos williams,0,2,0,3,5
khaos williams ,0,0,0,3,3
khusein askhabov,0,1,0,0,1
kiefer crosbie,0,2,0,0,2
kiichi kunimoto,0,1,0,1,2
kiichi kunimoto ,0,1,0,2,3
kimo leopoldo,0,3,0,0,3
kimo leopoldo ,0,0,0,2,2
king green ,0,1,0,0,1
kiru sahota ,0,1,0,0,1
kit cope,0,1,0,0,1
kj noons,0,2,0,2,4
kj noons ,0,1,1,0,2
klaudia sygula,0,1,0,0,1
kleydson rodrigues,0,2,0,1,3
kleydson rodrigues ,0,1,0,0,1
klidson abreu,0,2,1,1,4
koji kitao,0,1,0,0,1
koji oishi,0,2,0,0,2
konstantin erokhin,0,2,0,0,2
kris mccray,0,2,0,0,2
kris mccray ,0,1,0,0,1
kris moutinho,0,1,0,0,1
kris moutinho ,0,1,0,0,1
kristian rothaermel,0,1,0,0,1
kristof midoux,0,1,0,0,1
kron gracie,0,2,0,1,3
kron gracie ,0,1,0,0,1
krzysztof jotko,0,2,0,9,11
krzysztof jotko ,0,4,0,2,6
krzysztof soszynski,0,1,0,1,2
krzysztof soszynski ,0,2,0,5,7
kuniyoshi hironaka,0,3,0,0,3
kuniyoshi hironaka ,0,0,0,1,1
kurt holobaugh,0,3,0,0,3
kurt holobaugh ,0,2,0,2,4
kurt pellegrino,0,4,0,0,4
kurt pellegrino ,0,1,0,7,8
kwan ho kwak,0,1,0,0,1
kwan ho kwak ,0,1,0,0,1
kyle bochniak,0,3,0,1,4
kyle bochniak ,0,2,0,1,3
kyle bradley,0,3,0,0,3
kyle bradley ,0,0,0,1,1
kyle daukaus,0,4,1,0,5
kyle daukaus ,0,0,0,2,2
kyle kingsbury,0,2,0,2,4
kyle kingsbury ,0,3,0,2,5
kyle nelson,1,4,0,3,8
kyle nelson ,0,1,0,1,2
kyle noke,0,2,0,2,4
kyle noke ,0,4,0,4,8
kyle prepolec,0,1,0,0,1
kyle prepolec ,0,1,0,0,1
kyle stewart,0,1,0,0,1
kyle stewart ,0,1,0,0,1
kyle watson,0,1,0,1,2
kyler phillips,0,1,0,3,4
kyler phillips ,0,1,0,3,4
kyoji horiguchi,0,1,0,1,2
kyoji horiguchi ,0,0,0,6,6
kyung ho kang,0,4,1,2,7
kyung ho kang ,0,1,0,6,7
lance benoist,0,2,0,2,4
lance gibson,0,1,0,0,1
lance gibson ,0,0,0,1,1
lando vannata,1,2,0,1,4
lando vannata ,1,5,0,3,9
landon quinones,0,1,0,0,1
landon quinones ,0,1,0,0,1
lara procopio,0,2,0,1,3
larissa pacheco,0,1,0,0,1
larissa pacheco ,0,1,0,0,1
larry cureton,0,2,0,0,2
laureano staropoli,0,4,0,1,5
laureano staropoli ,0,0,0,1,1
lauren mueller,0,2,0,1,3
lauren mueller ,0,1,0,0,1
lauren murphy,0,4,0,2,6
lauren murphy ,0,2,0,6,8
lavar johnson,0,2,0,2,4
laverne clark,0,1,0,0,1
laverne clark ,0,0,0,4,4
leah letson,0,1,0,1,2
leandro issa,0,2,0,1,3
leandro issa ,0,1,0,1,2
leandro silva,0,4,0,1,5
leandro silva ,0,0,1,2,3
lee murray ,0,0,0,1,1
leigh remedios,0,1,0,0,1
leo kuntz,0,2,0,0,2
leon edwards,0,2,0,4,6
leon edwards ,0,1,1,10,12
leonard garcia,0,3,0,1,4
leonard garcia ,0,4,0,1,5
leonardo guimaraes,0,2,0,0,2
leonardo mafra,0,3,0,0,3
leonardo mafra ,0,0,0,1,1
leonardo morales,0,2,0,0,2
leonardo santos,0,1,0,2,3
leonardo santos ,1,2,0,5,8
lerone murphy,1,0,0,3,4
lerone murphy ,0,0,0,3,3
leslie smith,0,3,0,1,4
leslie smith ,0,0,0,3,3
levan makashvili,1,1,0,1,3
lewis gonzalez,0,1,0,0,1
li jingliang,0,4,0,3,7
li jingliang ,0,3,0,8,11
liana jojua,0,1,0,1,2
liana jojua ,0,2,0,0,2
liang na,0,1,0,0,1
liang na ,0,1,0,0,1
liliya shakirova,0,1,0,0,1
lina lansberg,0,3,0,2,5
lina lansberg ,0,4,0,2,6
lisa ellis,0,2,0,0,2
liudvik sholinian,0,1,0,0,1
liudvik sholinian ,0,1,0,0,1
livinha souza,0,0,0,1,1
livinha souza ,0,3,0,2,5
liz carmouche,0,4,0,0,4
liz carmouche ,0,1,0,5,6
lodune sincaid,0,1,0,0,1
logan clark ,0,0,0,1,1
loik radzhabov,0,1,0,2,3
loik radzhabov ,0,1,0,0,1
loma lookboonmee,0,0,0,1,1
loma lookboonmee ,0,2,0,5,7
lone'er kavanagh ,0,0,0,1,1
loopy godinez,0,4,0,5,9
loopy godinez ,0,1,0,2,3
lorenz larkin,0,2,0,5,7
lorenz larkin ,0,3,0,0,3
louis cosce,0,1,0,0,1
louis cosce ,0,1,0,0,1
louis gaudinot,0,1,1,0,2
louis gaudinot ,0,2,0,1,3
louis smolka,0,2,0,5,7
louis smolka ,0,7,0,3,10
lowell anderson,0,1,0,0,1
luan chagas,1,2,0,0,3
luan chagas ,0,0,0,1,1
luan lacerda,0,1,0,0,1
luan lacerda ,0,1,0,0,1
luana carolina,0,3,0,3,6
luana carolina ,0,0,0,3,3
luana pinheiro,0,0,0,2,2
luana pinheiro ,0,3,0,1,4
luana santos,0,1,0,1,2
luana santos ,0,0,0,2,2
lucas alexander,0,2,0,1,3
lucas almeida,0,2,0,2,4
lucas martins,0,2,0,1,3
lucas martins ,0,1,0,3,4
lucas rocha,0,1,0,0,1
lucie pudilova,0,7,0,3,10
lucie pudilova ,0,1,0,0,1
lucio linhares,0,2,0,0,2
ludovit klein,1,1,0,5,7
ludovit klein ,0,1,0,2,3
luigi fioravanti,0,5,0,0,5
luigi fioravanti ,0,0,0,4,4
luigi vendramini,0,3,0,0,3
luigi vendramini ,0,0,0,1,1
luis henrique,0,2,0,0,2
luis henrique ,0,2,0,2,4
luis pajuelo,0,1,0,0,1
luis pena,0,2,0,1,3
luis pena ,0,1,0,4,5
luis ramos,0,2,0,0,2
luis saldana,1,1,0,0,2
luis saldana ,0,0,0,2,2
luiz cane,0,2,0,0,2
luiz cane ,0,3,0,4,7
luiz dutra,0,1,0,0,1
luiz dutra ,0,1,0,0,1
lukasz brzeski,0,4,0,1,5
lukasz sajewski,0,2,0,0,2
lukasz sajewski ,0,1,0,0,1
luke barnatt,0,1,0,0,1
luke barnatt ,0,2,0,3,5
luke caudillo,0,2,0,0,2
luke cummo,0,4,0,0,4
luke cummo ,0,0,0,3,3
luke jumeau,0,1,0,0,1
luke jumeau ,0,1,0,2,3
luke rockhold,0,4,0,2,6
luke rockhold ,0,1,0,4,5
luke sanders,0,2,0,2,4
luke sanders ,0,3,0,1,4
luke zachrich,0,1,0,0,1
luke zachrich ,0,1,0,1,2
lyman good,0,2,0,1,3
lyman good ,0,1,0,2,3
lyoto machida,0,4,0,1,5
lyoto machida ,0,4,0,15,19
mac danzig,0,6,0,1,7
mac danzig ,0,2,0,4,6
maciej jewtuszko ,0,1,0,0,1
mackens semerzier,0,0,0,1,1
mackens semerzier ,0,1,1,0,2
mackenzie dern,0,2,0,2,4
mackenzie dern ,0,3,0,7,10
macy chiasson,0,2,0,5,7
macy chiasson ,0,1,0,3,4
mads burnell,0,2,0,0,2
mads burnell ,0,0,0,1,1
magnus cedenblad,0,1,0,1,2
magnus cedenblad ,0,1,0,3,4
magomed ankalaev,1,1,0,3,5
magomed ankalaev ,0,0,0,7,7
magomed gadzhiyasulov ,0,0,0,1,1
magomed mustafaev,0,2,0,2,4
magomed mustafaev ,0,0,0,1,1
maheshate ,0,2,0,1,3
maia stevenson ,0,1,0,0,1
maiquel falcao,0,0,0,1,1
mairbek taisumov,0,1,0,0,1
mairbek taisumov ,0,1,0,7,8
mairon santos,0,0,0,1,1
makhmud muradov,0,0,1,2,3
makhmud muradov ,0,2,0,2,4
maki pitolo,0,1,0,1,2
maki pitolo ,0,4,0,0,4
makwan amirkhani,0,4,0,4,8
makwan amirkhani ,0,3,0,3,6
malcolm gordon,0,3,0,1,4
malcolm gordon ,0,2,0,1,3
mallory martin,0,3,0,0,3
mallory martin ,0,0,0,1,1
mana martinez ,0,2,0,2,4
mandy bohm,0,1,0,1,2
mandy bohm ,0,1,0,0,1
manel kape,0,2,0,1,3
manel kape ,0,1,0,4,5
manny bermudez,0,1,0,3,4
manny bermudez ,0,1,0,0,1
manolo zecchini,0,1,0,0,1
manon fiorot,0,0,0,4,4
manon fiorot ,0,0,0,3,3
mansur abdul-malik ,0,0,0,1,1
manuel rodriguez,0,1,0,0,1
manuel torres,0,0,0,1,1
manuel torres ,0,1,0,2,3
manvel gamburyan,0,6,1,1,8
manvel gamburyan ,0,2,0,5,7
mara romero borella,0,5,0,0,5
mara romero borella ,0,0,0,2,2
marc diakiese,0,3,0,3,6
marc diakiese ,0,4,0,5,9
marc-andre barriault,0,5,0,3,8
marc-andre barriault ,0,3,1,2,6
marcel fortuna,0,2,0,1,3
marcelo aguiar,0,1,0,0,1
marcelo golm,0,3,0,0,3
marcelo golm ,0,0,0,1,1
marcelo guimaraes,0,1,0,0,1
marcelo guimaraes ,0,1,0,2,3
marcelo mello ,0,0,0,1,1
marcelo rojo,0,2,0,0,2
marcelo rojo ,0,1,0,0,1
marcin bandel,0,1,0,0,1
marcin bandel ,0,1,0,0,1
marcin held,0,2,0,0,2
marcin held ,0,1,0,1,2
marcin prachnio,0,4,0,3,7
marcin prachnio ,0,2,0,1,3
marcin tybura,0,5,0,5,10
marcin tybura ,0,3,0,8,11
marcin wrzosek,0,1,0,0,1
marcio alexandre junior,0,1,0,0,1
marcio alexandre junior ,0,2,0,0,2
marcio cruz,0,2,0,0,2
marcio cruz ,0,0,0,2,2
marco beltran,0,1,0,1,2
marco beltran ,0,2,0,2,4
marco polo reyes,0,3,0,2,5
marco polo reyes ,0,1,0,2,3
marco ruas,0,2,0,0,2
marco ruas ,0,0,0,4,4
marcos mariano,0,2,0,0,2
marcos rogerio de lima,0,5,0,5,10
marcos rogerio de lima ,0,2,0,6,8
marcos vinicius,0,1,0,0,1
marcos vinicius ,0,1,0,1,2
marcus aurelio,0,4,0,0,4
marcus aurelio ,0,0,0,2,2
marcus bossett,0,2,0,0,2
marcus bossett ,0,0,0,1,1
marcus brimage,0,0,0,2,2
marcus brimage ,0,4,0,2,6
marcus davis,0,6,0,0,6
marcus davis ,0,0,0,9,9
marcus jones,0,1,0,0,1
marcus levesseur,0,1,0,0,1
marcus levesseur ,0,1,0,1,2
marcus mcghee,0,0,0,3,3
marcus mcghee ,0,0,0,1,1
marcus silveira,0,1,1,0,2
maria oliveira,0,3,0,0,3
maria oliveira ,0,0,0,1,1
marina rodriguez,1,2,0,2,5
marina rodriguez ,1,3,0,5,9
mario bautista,0,1,0,5,6
mario bautista ,0,1,0,4,5
mario miranda,0,2,0,1,3
mario miranda ,0,1,0,0,1
mario neto,0,1,0,0,1
marion reneau,1,3,0,3,7
marion reneau ,0,4,0,2,6
mariya agapova,0,2,0,1,3
mariya agapova ,0,2,0,1,3
mark bocek,0,3,0,0,3
mark bocek ,0,2,0,8,10
mark coleman,0,5,0,0,5
mark coleman ,0,0,0,7,7
mark de la rosa,0,4,0,0,4
mark de la rosa ,0,1,0,2,3
mark eddiva,0,2,0,1,3
mark eddiva ,0,1,0,0,1
mark godbeer,0,1,0,1,2
mark godbeer ,0,1,0,1,2
mark hall,0,3,0,0,3
mark hall ,0,0,0,4,4
mark holst,0,2,0,0,2
mark hominick,0,1,0,0,1
mark hominick ,0,3,0,3,6
mark hughes ,0,0,0,1,1
mark hunt,0,4,1,3,8
mark hunt ,1,4,0,5,10
mark kerr ,0,0,0,4,4
mark madsen,0,2,0,2,4
mark madsen ,0,0,0,2,2
mark munoz,0,2,0,4,6
mark munoz ,0,4,0,5,9
mark robinson,0,0,1,0,1
mark scanlon,0,1,0,0,1
mark schultz ,0,0,0,1,1
mark striegl,0,2,0,0,2
mark weir,0,2,0,0,2
mark weir ,0,0,0,1,1
markus perez,0,3,0,0,3
markus perez ,0,2,0,2,4
marlon moraes,0,2,0,3,5
marlon moraes ,0,4,0,2,6
marlon vera,0,7,0,6,13
marlon vera ,0,2,0,9,11
marnic mann,0,1,0,0,1
marnic mann ,0,1,0,0,1
marquel mederos,0,0,0,1,1
martin bravo,0,1,0,0,1
martin bravo ,0,2,0,1,3
martin buday,0,0,0,3,3
martin buday ,0,1,0,2,3
martin day,0,2,0,0,2
martin day ,0,2,0,0,2
martin kampmann,0,6,0,4,10
martin kampmann ,0,0,0,7,7
martin sano,0,1,0,0,1
martin svensson,0,1,0,0,1
marvin eastman,0,4,0,0,4
marvin eastman ,0,0,0,1,1
marvin vettori,0,4,0,5,9
marvin vettori ,1,1,0,4,6
maryna moroz,0,4,0,3,7
maryna moroz ,0,2,0,3,5
masanori kanehara,0,2,0,1,3
masio fullen,0,2,0,0,2
masio fullen ,0,0,0,1,1
mason jones,0,1,1,0,2
mason jones ,0,1,0,1,2
masutatsu yano,0,1,0,0,1
mateus mendonca,0,3,0,0,3
mateusz gamrot,0,1,0,5,6
mateusz gamrot ,0,2,0,2,4
mateusz rebecki,0,1,0,0,1
mateusz rebecki ,0,0,0,3,3
matheus nicolau,0,2,0,5,7
matheus nicolau ,0,2,0,2,4
mats nilsson,0,2,0,0,2
matt andersen,0,1,0,0,1
matt arroyo,0,2,0,0,2
matt arroyo ,0,0,0,1,1
matt bessette ,0,2,0,0,2
matt brown,0,8,0,1,9
matt brown ,0,5,0,16,21
matt dwyer,0,2,0,1,3
matt dwyer ,0,1,0,0,1
matt frevola,0,2,0,2,4
matt frevola ,1,3,0,3,7
matt grice,0,5,0,1,6
matt grice ,0,0,0,1,1
matt hamill,0,4,0,2,6
matt hamill ,0,1,0,8,9
matt hobar,0,2,0,1,3
matt horwich,0,2,0,0,2
matt hughes,0,5,0,0,5
matt hughes ,0,2,0,18,20
matt lindland,0,3,0,0,3
matt lindland ,0,0,0,9,9
matt lucas,0,1,0,0,1
matt mitrione,0,5,0,3,8
matt mitrione ,0,0,0,6,6
matt sayles,0,2,0,1,3
matt sayles ,0,1,0,0,1
matt schnell,0,5,0,2,7
matt schnell ,0,2,1,4,7
matt serra,0,6,0,0,6
matt serra ,0,1,0,7,8
matt van buren,0,1,0,0,1
matt van buren ,0,1,0,0,1
matt veach,0,2,0,0,2
matt veach ,0,0,0,1,1
matt wiman,0,6,0,3,9
matt wiman ,0,2,0,7,9
matthew lopez,0,3,0,2,5
matthew lopez ,0,1,0,0,1
matthew riddle,0,1,2,1,4
matthew riddle ,0,2,0,6,8
matthew semelsberger,0,3,0,2,5
matthew semelsberger ,0,3,0,3,6
maurice greene,0,1,0,1,2
maurice greene ,0,3,0,3,6
maurice smith,0,3,0,0,3
maurice smith ,0,0,0,4,4
mauricio rua,0,2,0,1,3
mauricio rua ,1,10,0,10,21
mauricio ruffy ,0,0,0,2,2
max griffin,0,7,0,5,12
max griffin ,0,2,0,3,5
max holloway,0,5,0,6,11
max holloway ,0,2,0,15,17
max rohskopf,0,1,0,0,1
maxim grishin,0,3,0,2,5
maximo blanco,0,4,0,2,6
maximo blanco ,0,1,0,2,3
maycee barber,0,1,0,5,6
maycee barber ,0,1,0,4,5
mayra bueno silva,1,2,0,2,5
mayra bueno silva ,0,2,0,4,6
megan anderson,0,2,0,1,3
megan anderson ,0,1,0,2,3
mehdi baghdad,0,2,0,0,2
melinda fabian,1,1,0,0,2
melissa dixon,0,0,0,1,1
melissa gatto,0,2,0,3,5
melissa martinez ,0,1,0,1,2
melissa mullins ,0,1,0,1,2
melquizael costa,0,2,0,1,3
melquizael costa ,0,0,0,1,1
melsik baghdasaryan,0,1,0,2,3
melsik baghdasaryan ,0,0,0,1,1
melton bowen,0,1,0,0,1
melvin guillard,0,6,1,1,8
melvin guillard ,0,3,0,11,14
merab dvalishvili,0,1,0,7,8
merab dvalishvili ,0,1,0,4,5
michael bisping,0,6,0,2,8
michael bisping ,0,3,0,18,21
michael chandler,0,4,0,1,5
michael chandler ,0,0,0,1,1
michael chiesa,0,1,0,7,8
michael chiesa ,0,6,0,6,12
michael graves,0,0,0,1,1
michael graves ,1,0,0,1,2
michael johnson,0,6,0,5,11
michael johnson ,0,9,0,10,19
michael kuiper,0,2,0,1,3
michael kuiper ,0,1,0,0,1
michael mcbride,0,2,0,0,2
michael mcdonald,0,2,0,2,4
michael mcdonald ,0,1,0,4,5
michael morales,0,0,0,2,2
michael morales ,0,0,0,3,3
michael page,0,1,0,1,2
michael patt,0,2,0,0,2
michael trizano,0,1,0,1,2
michael trizano ,0,2,0,3,5
michal figlak,0,2,0,0,2
michal oleksiejczuk,0,6,1,6,13
michal oleksiejczuk ,0,1,0,0,1
micheal gillmore,0,2,0,0,2
michel batista,0,1,0,0,1
michel pereira,0,2,0,4,6
michel pereira ,0,1,0,5,6
michel prazeres,0,2,0,3,5
michel prazeres ,0,2,0,7,9
michel quinones,0,2,0,0,2
michelle waterson,0,5,0,3,8
michelle waterson ,0,0,0,3,3
michelle waterson-gomez,0,1,0,0,1
michelle waterson-gomez ,0,3,0,0,3
michihiro omigawa,0,6,0,0,6
michihiro omigawa ,0,0,0,1,1
michinori tanaka,0,2,0,2,4
michinori tanaka ,0,1,0,0,1
mick parkin,0,0,0,1,1
mick parkin ,0,0,0,3,3
mickael lebout,0,2,0,0,2
mickael lebout ,0,0,0,1,1
mickey gall,0,4,0,2,6
mickey gall ,0,3,0,4,7
miesha tate,0,3,0,2,5
miesha tate ,0,3,0,5,8
miguel baeza,0,1,0,1,2
miguel baeza ,0,3,0,2,5
miguel torres ,0,2,0,2,4
mike breeden,0,3,0,0,3
mike brown,0,2,0,0,2
mike brown ,0,2,0,2,4
mike ciesnolevicz,0,1,0,0,1
mike ciesnolevicz ,0,0,0,1,1
mike davis,0,1,0,1,2
mike davis ,0,0,0,3,3
mike de la torre,0,4,0,2,6
mike de la torre ,0,0,1,0,1
mike easton,0,4,0,1,5
mike easton ,0,0,0,2,2
mike grundy,0,2,0,0,2
mike grundy ,0,1,0,1,2
mike guymon,0,2,0,1,3
mike guymon ,0,1,0,0,1
mike jackson,0,1,1,1,3
mike jackson ,0,1,0,0,1
mike king,0,1,0,0,1
mike kyle,0,1,0,0,1
mike kyle ,0,0,0,2,2
mike lullo,0,1,0,0,1
mike lullo ,0,1,0,0,1
mike malott,0,1,0,1,2
mike malott ,0,0,0,3,3
mike massenzio,0,3,0,1,4
mike massenzio ,0,2,0,1,3
mike nickels,0,1,0,0,1
mike nickels ,0,0,0,1,1
mike perry,0,5,0,5,10
mike perry ,0,3,0,2,5
mike pierce,0,5,0,1,6
mike pierce ,0,0,0,8,8
mike pyle,0,4,0,3,7
mike pyle ,0,5,0,7,12
mike rhodes,0,3,0,0,3
mike ricci,0,1,0,0,1
mike ricci ,0,1,0,1,2
mike rio,0,3,0,0,3
mike rio ,0,0,0,1,1
mike rodriguez,0,3,0,2,5
mike rodriguez ,0,2,1,0,3
mike russow,0,1,0,2,3
mike russow ,0,1,0,2,3
mike santiago,0,1,0,0,1
mike santiago ,0,2,0,0,2
mike stumpf,0,1,0,0,1
mike stumpf ,0,1,0,0,1
mike swick,0,3,0,0,3
mike swick ,0,2,0,10,12
mike van arsdale,0,2,0,0,2
mike van arsdale ,0,0,0,2,2
mike wessel,0,1,0,0,1
mike whitehead,0,1,0,0,1
mike wilkinson,0,1,0,2,3
mike wilkinson ,0,1,0,0,1
mikey burnett,0,1,0,0,1
mikey burnett ,0,0,0,2,2
milana dudieva,0,2,0,1,3
miles johns,0,0,0,4,4
miles johns ,0,3,0,3,6
milton vieira,1,1,0,0,2
minoki ichihara,0,1,0,0,1
miranda granger,0,2,0,0,2
miranda granger ,0,1,0,1,2
miranda maverick,0,0,0,4,4
miranda maverick ,0,3,0,4,7
mirko filipovic,0,4,0,1,5
mirko filipovic ,0,2,0,4,6
mirsad bektic,0,1,0,2,3
mirsad bektic ,0,3,0,4,7
misha cirkunov,0,2,0,1,3
misha cirkunov ,0,5,0,5,10
mitch clarke,0,2,0,1,3
mitch clarke ,0,3,0,1,4
mitch gagnon,0,2,0,0,2
mitch gagnon ,0,2,0,4,6
mitch ramirez,0,1,0,0,1
mitch raposo ,0,1,0,0,1
mizuki,0,0,0,1,1
mizuto hirota,0,3,0,1,4
mizuto hirota ,1,2,0,0,3
modestas bukauskas,0,2,0,2,4
modestas bukauskas ,0,2,0,2,4
mohammad yahya ,0,1,0,0,1
mohammed usman ,0,2,0,3,5
molly mccann,0,2,0,1,3
molly mccann ,0,4,0,6,10
montana de la rosa,0,4,0,2,6
montana de la rosa ,1,1,0,4,6
montel jackson,0,2,0,3,5
montel jackson ,0,0,0,5,5
montserrat conejo,0,1,0,1,2
montserrat conejo ruiz,0,2,0,0,2
montserrat rendon,0,0,0,1,1
montserrat rendon ,0,1,0,0,1
morgan charriere ,0,1,0,2,3
mostapha al-turk,0,3,0,0,3
moti horenstein,0,2,0,0,2
motonobu tezuka,0,2,0,0,2
mounir lazzez,0,2,0,1,3
mounir lazzez ,0,0,0,1,1
movsar evloev,0,0,0,4,4
movsar evloev ,0,0,0,5,5
muhammad mokaev,0,0,0,1,1
muhammad mokaev ,0,0,0,5,5
muhammad naimov,0,0,0,2,2
muhammad naimov ,0,1,0,0,1
muin gafurov,0,1,0,1,2
murilo bustamante,0,1,0,0,1
murilo bustamante ,0,0,0,3,3
muslim salikhov,0,3,0,6,9
muslim salikhov ,0,1,0,2,3
myktybek orolbai,0,0,0,2,2
myles jury,0,3,0,4,7
myles jury ,0,1,0,4,5
na liang ,0,1,0,0,1
nad narimani,0,2,0,1,3
nad narimani ,0,0,0,1,1
nadia kassem,0,1,0,1,2
nadia kassem ,0,1,0,0,1
nah-shon burrell,0,1,0,0,1
nah-shon burrell ,0,0,0,1,1
nam phan,0,3,0,2,5
nam phan ,0,3,0,0,3
nandor guelmino ,0,1,0,0,1
naoki inoue,0,1,0,0,1
naoki inoue ,0,0,0,1,1
naoyuki kotani,0,4,0,0,4
naoyuki kotani ,0,1,0,0,1
nasrat haqparast,0,4,0,3,7
nasrat haqparast ,0,0,0,6,6
nassourdine imavov,0,2,0,4,6
nassourdine imavov ,0,0,1,3,4
natalia silva,0,0,0,4,4
natalia silva ,0,0,0,2,2
natan levy,0,1,0,0,1
natan levy ,0,1,0,2,3
nate diaz,0,7,0,4,11
nate diaz ,0,4,0,12,16
nate landwehr,0,2,0,1,3
nate landwehr ,0,2,0,4,6
nate loughran,0,1,0,0,1
nate loughran ,0,0,0,1,1
nate maness,0,1,0,3,4
nate maness ,0,1,0,2,3
nate marquardt,0,8,0,3,11
nate marquardt ,0,4,0,10,14
nate mohr,0,3,0,0,3
nate mohr ,0,0,0,1,1
nate quarry,0,2,0,0,2
nate quarry ,0,1,0,7,8
nate schroeder,0,1,0,0,1
nathan coy,0,2,0,1,3
nathan fletcher,0,0,0,1,1
nathaniel wood,0,1,0,2,3
nathaniel wood ,0,1,0,6,7
navajo stirling ,0,0,0,1,1
nazareno malegarie,0,1,0,0,1
nazim sadykhov ,1,0,0,2,3
neil grove,0,1,0,0,1
neil magny,0,4,0,7,11
neil magny ,0,8,0,15,23
neil seery,0,3,0,0,3
neil seery ,0,1,0,3,4
neil wain,0,1,0,0,1
nicco montano,0,1,0,0,1
nicco montano ,0,0,0,1,1
nicholas musoke,0,1,0,2,3
nicholas musoke ,0,2,0,1,3
nick agallar,0,1,0,0,1
nick aguirre,0,2,0,0,2
nick catone,0,3,0,1,4
nick catone ,0,1,0,3,4
nick denis,0,1,0,1,2
nick diaz,0,5,1,1,7
nick diaz ,0,2,0,6,8
nick fiore,0,2,0,0,2
nick hein,0,2,0,0,2
nick hein ,0,2,0,4,6
nick maximov,0,0,0,2,2
nick maximov ,0,2,0,0,2
nick osipczak,0,1,0,0,1
nick osipczak ,0,2,0,2,4
nick pace,0,2,0,1,3
nick penner,0,1,0,0,1
nick penner ,0,1,0,0,1
nick ring,0,0,0,1,1
nick ring ,0,3,0,2,5
nick roehrick,0,1,0,0,1
nick sanzo,0,1,0,0,1
nick sanzo ,0,0,0,1,1
nick serra,0,1,0,0,1
nick thompson,0,1,0,0,1
nick thompson ,0,0,0,1,1
nicolae negumereanu,0,1,0,1,2
nicolae negumereanu ,0,1,0,3,4
nicolas dalby,0,3,0,5,8
nicolas dalby ,1,1,1,2,5
nik lentz,1,5,0,9,15
nik lentz ,0,4,1,5,10
nikita krylov,0,4,0,6,10
nikita krylov ,0,3,0,5,8
niklas backstrom,0,0,0,1,1
niklas backstrom ,0,2,0,0,2
niklas stolze,0,1,0,0,1
niklas stolze ,0,2,0,0,2
niko price,0,6,2,5,13
niko price ,0,2,0,3,5
nikolas motta,0,2,1,1,4
nikolas motta ,0,0,0,2,2
nikolay veretennikov,0,1,0,0,1
nina nunes,0,3,0,5,8
nina nunes ,0,1,0,0,1
nissen osterneck,0,1,0,0,1
noad lahat,0,1,0,2,3
noad lahat ,0,1,0,0,1
noe hernandez,0,1,0,0,1
nohelin hernandez,0,2,0,0,2
nolan ticman ,0,2,0,0,2
nora cornolle,0,0,0,1,1
nora cornolle ,0,1,0,1,2
nordine taleb,0,2,0,2,4
nordine taleb ,0,3,0,5,8
norifumi yamamoto,0,0,1,0,1
norifumi yamamoto ,0,3,0,0,3
norma dumont,0,2,0,5,7
norma dumont ,0,0,0,3,3
norman parke,1,1,0,1,3
norman parke ,0,2,0,4,6
nursulton ruziboev,0,1,0,1,2
nursulton ruziboev ,0,0,0,1,1
nurullo aliev,0,0,0,1,1
nyamjargal tumendemberel ,0,1,0,0,1
oban elliott,0,0,0,1,1
oban elliott ,0,0,0,2,2
ode osbourne,0,4,0,1,5
ode osbourne ,0,2,0,3,5
oleg taktarov,0,2,0,0,2
oleg taktarov ,0,0,0,6,6
oli thompson,0,1,0,0,1
oli thompson ,0,1,0,0,1
oliver enkamp,0,1,0,0,1
oliver enkamp ,0,1,0,0,1
olivier aubin-mercier,0,2,0,2,4
olivier aubin-mercier ,0,3,0,5,8
oluwale bamgbose,0,3,0,1,4
oluwale bamgbose ,0,1,0,0,1
omar morales,0,3,0,3,6
omar morales ,0,1,0,0,1
omari akhmedov,1,2,0,6,9
omari akhmedov ,0,3,0,3,6
onassis parungao ,0,0,0,1,1
orion cosce,0,1,0,0,1
orion cosce ,0,1,0,1,2
orlando wiet,0,1,0,0,1
orlando wiet ,0,0,0,1,1
oskar piechota,0,3,1,0,4
oskar piechota ,0,0,0,2,2
ottman azaitar,0,2,0,0,2
ottman azaitar ,0,1,0,2,3
oumar sy ,0,0,0,2,2
ovince saint preux,0,6,0,5,11
ovince saint preux ,0,7,0,10,17
ozzy diaz,0,1,0,0,1
pablo garza,0,3,0,3,6
paddy holohan ,0,2,0,3,5
paddy pimblett,0,0,0,2,2
paddy pimblett ,0,0,0,4,4
paige vanzant,0,2,0,1,3
paige vanzant ,0,2,0,4,6
pannie kianzad,0,3,0,4,7
pannie kianzad ,0,3,0,1,4
papy abedi,0,2,0,0,2
papy abedi ,0,1,0,1,2
parker porter,0,3,0,2,5
parker porter ,0,0,0,2,2
pascal krauss,0,1,0,1,2
pascal krauss ,0,1,0,1,2
pat audinwood,0,1,0,0,1
pat audinwood ,0,1,0,0,1
pat barry,0,3,0,0,3
pat barry ,0,4,0,5,9
pat healy,0,4,1,0,5
pat healy ,0,1,0,0,1
pat miletich,0,2,0,0,2
pat miletich ,0,0,0,8,8
pat sabatini,0,2,0,2,4
pat sabatini ,0,0,0,4,4
pat schilling,0,2,0,0,2
patrick cote,0,8,0,0,8
patrick cote ,0,3,0,10,13
patrick cummins,0,6,0,3,9
patrick cummins ,0,1,0,3,4
patrick smith,0,1,0,0,1
patrick smith ,0,0,0,4,4
patrick walsh,0,1,0,0,1
patrick walsh ,0,0,0,1,1
patrick williams,0,2,0,1,3
patrick williams ,0,1,0,0,1
paul bradley,0,2,0,0,2
paul buentello,0,3,0,0,3
paul buentello ,0,0,0,3,3
paul craig,1,6,0,5,12
paul craig ,0,3,0,4,7
paul creighton,0,1,0,0,1
paul daley,0,1,0,0,1
paul daley ,0,0,0,2,2
paul felder,0,3,0,7,10
paul felder ,0,3,0,2,5
paul georgieff,0,1,0,0,1
paul herrera,0,1,0,0,1
paul jones,0,1,0,0,1
paul jones ,0,0,0,1,1
paul kelly,0,3,0,0,3
paul kelly ,0,1,0,5,6
paul redmond,0,2,0,0,2
paul rodriguez,0,1,0,0,1
paul sass,0,0,0,2,2
paul sass ,0,2,0,1,3
paul taylor,0,5,0,0,5
paul taylor ,0,0,0,4,4
paul varelans,0,4,0,0,4
paul varelans ,0,0,0,4,4
paulo costa,0,3,0,4,7
paulo costa ,0,1,0,2,3
paulo santos,0,1,0,0,1
paulo thiago,0,3,0,0,3
paulo thiago ,0,5,0,5,10
pawel pawlak,0,2,0,0,2
pawel pawlak ,0,0,0,1,1
payton talbott ,0,0,0,3,3
pearl gonzalez,0,1,0,0,1
pearl gonzalez ,0,1,0,0,1
pedro falcao ,0,1,0,0,1
pedro munhoz,0,6,0,2,8
pedro munhoz ,0,4,2,8,14
pedro nobre,0,0,1,0,1
pedro rizzo,0,5,0,0,5
pedro rizzo ,0,0,0,9,9
peggy morgan,0,1,0,0,1
per eklund,0,2,0,0,2
per eklund ,0,0,0,1,1
pete rodriguez,0,2,0,1,3
pete sell,0,5,0,0,5
pete sell ,0,0,0,2,2
pete spratt,0,4,0,0,4
pete spratt ,0,0,0,3,3
pete williams,0,5,0,0,5
pete williams ,0,0,0,3,3
peter barrett,0,2,0,0,2
peter sobotta,0,6,0,0,6
peter sobotta ,0,0,0,4,4
petr yan,0,1,0,4,5
petr yan ,0,3,0,6,9
phil baroni,0,6,0,0,6
phil baroni ,0,1,0,3,4
phil davis,0,1,0,4,5
phil davis ,0,2,1,5,8
phil harris,0,2,0,0,2
phil harris ,0,1,1,1,3
phil hawes,0,0,0,1,1
phil hawes ,0,4,0,3,7
phil johns,0,1,0,0,1
phil rowe,0,2,0,2,4
phil rowe ,0,1,0,1,2
philip de fries,0,2,0,1,3
philip de fries ,0,1,0,1,2
philipe lins,0,1,0,3,4
philipe lins ,0,1,0,1,2
phillip miller ,0,0,0,2,2
phillipe nover,0,6,0,0,6
phillipe nover ,0,0,0,1,1
piera rodriguez,0,1,0,1,2
piera rodriguez ,0,1,0,2,3
pingyuan liu,0,1,0,1,2
pingyuan liu ,0,1,0,1,2
piotr hallmann,0,3,0,2,5
piotr hallmann ,0,1,0,0,1
poliana botelho,0,3,0,2,5
poliana botelho ,0,1,0,1,2
polyana viana,0,2,0,1,3
polyana viana ,0,4,0,3,7
preston parsons,0,3,0,1,4
preston parsons ,0,0,0,1,1
priscila cachoeira,0,6,0,2,8
priscila cachoeira ,0,0,0,2,2
puja tomar,0,0,0,1,1
punahele soriano,0,0,0,1,1
punahele soriano ,0,4,0,3,7
quang le,0,2,0,0,2
quinn mulhern,0,2,0,0,2
quinton jackson,0,2,0,0,2
quinton jackson ,0,3,0,8,11
rachael ostovich,0,3,0,1,4
rafa garcia,0,4,0,1,5
rafa garcia ,0,0,0,3,3
rafael alves,0,1,0,1,2
rafael alves ,0,2,0,0,2
rafael carino ,0,0,0,1,1
rafael cavalcante,0,3,0,0,3
rafael cavalcante ,0,1,0,1,2
rafael dos anjos,0,6,0,11,17
rafael dos anjos ,0,8,0,10,18
rafael estevam,0,0,0,1,1
rafael fiziev,0,2,0,6,8
rafael fiziev ,0,1,0,0,1
rafael natal,1,4,0,1,6
rafael natal ,0,3,0,8,11
rafaello oliveira,0,5,0,0,5
rafaello oliveira ,0,1,0,2,3
rainy martinez,0,1,0,0,1
ramazan emeev,0,2,0,3,5
ramazan emeev ,0,1,0,2,3
ramazan temirov,0,0,0,1,1
rameau thierry sokoudjou,0,2,0,0,2
rameau thierry sokoudjou ,0,0,0,1,1
ramiro hernandez,0,1,0,0,1
ramiro hernandez ,0,1,0,0,1
ramiz brahimaj,0,3,0,2,5
ramiz brahimaj ,0,0,0,1,1
ramon taveras,0,1,0,1,2
ramona pascual,0,2,0,0,2
ramona pascual ,0,1,0,0,1
ramsey nijem ,0,5,0,5,10
randa markos,0,4,0,2,6
randa markos ,1,6,0,5,12
randy brown,0,2,0,5,7
randy brown ,0,4,0,8,12
randy costa,0,3,0,1,4
randy costa ,0,1,0,1,2
randy couture,0,8,0,0,8
randy couture ,0,0,0,16,16
rani yahya,0,1,0,3,4
rani yahya ,1,5,1,10,17
raoni barcelos,0,2,0,2,4
raoni barcelos ,0,2,0,5,7
raphael assuncao,0,2,0,0,2
raphael assuncao ,0,5,0,12,17
raphael pessoa,0,2,0,0,2
raphael pessoa ,0,0,0,1,1
raquel pennington,0,2,0,7,9
raquel pennington ,0,4,0,6,10
rashad coulter,0,1,0,1,2
rashad coulter ,0,2,0,0,2
rashad evans,0,5,0,1,6
rashad evans ,1,3,0,13,17
rashid magomedov,0,1,0,5,6
raul rosas jr. ,0,1,0,4,5
raulian paiva,0,2,0,2,4
raulian paiva ,0,2,0,1,3
ravena oliveira,0,1,0,0,1
ray borg,0,3,0,3,6
ray borg ,0,2,0,4,6
ray rodriguez,0,2,0,0,2
ray wizard,0,1,0,0,1
rayanne amanda ,0,1,0,0,1
rayanne dos santos ,0,1,0,0,1
razak al-hassan,0,2,0,0,2
reese andy,0,2,0,0,2
reginaldo vieira,0,2,0,0,2
reginaldo vieira ,0,0,0,1,1
rei tsuruya ,0,0,0,1,1
reinier de ridder,0,0,0,1,1
remco pardoel,0,2,0,0,2
remco pardoel ,0,0,0,3,3
renan barao,0,3,0,3,6
renan barao ,0,5,0,6,11
renato moicano,0,3,0,6,9
renato moicano ,0,2,0,6,8
renato sobral,0,4,0,0,4
renato sobral ,0,0,0,6,6
renato verissimo,0,2,0,0,2
renato verissimo ,0,0,0,1,1
renee forte,0,2,0,1,3
renee forte ,0,1,0,0,1
renzo gracie,0,1,0,0,1
reuben duran,0,2,0,0,2
reuben duran ,0,1,0,1,2
rex holman,0,1,0,0,1
reza madadi,0,3,0,1,4
reza madadi ,0,1,0,2,3
reza nasri,0,1,0,0,1
rhys mckee,0,4,0,0,4
ricardo abreu ,0,1,0,1,2
ricardo almeida,0,4,0,1,5
ricardo almeida ,0,1,0,5,6
ricardo funch,0,2,0,0,2
ricardo funch ,0,2,0,0,2
ricardo lamas,0,3,0,3,6
ricardo lamas ,0,3,0,8,11
ricardo ramos,0,0,0,2,2
ricardo ramos ,0,5,0,6,11
ricardo romero,0,2,0,1,3
ricco rodriguez,0,2,0,0,2
ricco rodriguez ,0,0,0,5,5
rich attonito,0,0,0,2,2
rich attonito ,0,2,0,1,3
rich clementi,0,5,0,0,5
rich clementi ,0,0,0,5,5
rich franklin,0,5,0,2,7
rich franklin ,0,1,0,12,13
richard crunkilton,0,1,0,0,1
richard walsh,0,2,0,0,2
richard walsh ,0,2,0,2,4
richardson moreira,0,1,0,0,1
richardson moreira ,0,1,0,0,1
richie hightower,0,1,0,0,1
richie smullen,0,1,0,0,1
richie vaculik ,0,3,0,1,4
rick davis,0,1,0,0,1
rick story,0,5,0,7,12
rick story ,0,2,0,5,7
ricky glenn,1,4,0,3,8
ricky glenn ,0,2,0,1,3
ricky rainey,0,2,0,0,2
ricky simon,0,3,0,3,6
ricky simon ,0,2,0,5,7
ricky turcios,0,2,0,0,2
ricky turcios ,0,0,0,2,2
riki fukuda,0,2,0,0,2
riki fukuda ,0,1,0,2,3
rin nakai,0,2,0,0,2
rinat fakhretdinov,0,0,0,2,2
rinat fakhretdinov ,1,0,0,2,3
rinya nakamura,0,0,0,1,1
rinya nakamura ,0,0,0,1,1
roan carneiro,0,5,0,1,6
roan carneiro ,0,0,0,3,3
rob broughton,0,1,0,0,1
rob broughton ,0,1,0,1,2
rob emerson,0,2,1,0,3
rob emerson ,0,1,0,3,4
rob font,0,4,0,3,7
rob font ,0,3,0,8,11
rob kimmons,0,3,0,0,3
rob kimmons ,0,1,0,3,4
rob macdonald,0,2,0,0,2
rob macdonald ,0,0,0,1,1
rob wilkinson,0,1,0,0,1
rob wilkinson ,0,1,0,0,1
rob yundt,0,2,0,0,2
robbie lawler,0,5,0,4,9
robbie lawler ,0,5,0,11,16
robelis despaigne,0,2,0,0,2
robelis despaigne ,0,0,0,1,1
robert bryczek ,0,1,0,0,1
robert drysdale ,0,0,1,0,1
robert lucarelli,0,1,0,0,1
robert mcdaniel,0,1,0,0,1
robert mcdaniel ,0,1,0,1,2
robert peralta,0,3,1,2,6
robert peralta ,0,0,0,2,2
robert sanchez,0,1,0,0,1
robert sanchez ,0,1,0,1,2
robert valentin ,0,1,0,0,1
robert whiteford,0,2,0,1,3
robert whiteford ,0,1,0,1,2
robert whittaker,0,2,0,5,7
robert whittaker ,0,3,0,12,15
roberto romero,0,1,0,0,1
roberto traven,0,1,0,0,1
roberto traven ,0,0,0,1,1
rocky lee,0,1,0,0,1
rodney wallace,0,1,0,0,1
rodney wallace ,0,2,0,0,2
rodolfo bellato ,0,0,0,1,1
rodolfo rubio perez,0,1,0,0,1
rodolfo vieira,0,1,0,0,1
rodolfo vieira ,0,1,0,5,6
rodrigo damm,0,3,0,1,4
rodrigo damm ,0,1,0,2,3
rodrigo de lima,0,2,0,0,2
rodrigo nascimento,0,3,0,3,6
rodrigo nascimento ,0,0,0,2,2
rodrigo ruas,0,1,0,0,1
roger bowling,0,2,0,0,2
roger bowling ,0,0,1,0,1
roger gracie,0,1,0,0,1
roger hollett,0,2,0,0,2
roger huerta,0,2,0,0,2
roger huerta ,0,0,0,6,6
roger narvaez,0,2,0,1,3
roger zapata,0,1,0,0,1
rogerio bontorin,0,1,1,1,3
rogerio bontorin ,0,2,0,1,3
rogerio nogueira,0,5,0,4,9
rogerio nogueira ,0,2,0,2,4
roland delorme ,0,3,1,3,7
roland payne,0,1,0,0,1
rolando bedoya,0,2,0,0,2
rolando delgado,0,2,0,0,2
rolando delgado ,0,0,0,1,1
rolando dy,0,2,0,1,3
rolando dy ,0,1,0,0,1
roldan sangcha'an,0,1,0,0,1
roldan sangcha'an ,0,1,0,0,1
rolles gracie,0,1,0,0,1
roman bogatov,0,1,0,0,1
roman dolidze,0,2,0,3,5
roman dolidze ,0,1,0,5,6
roman kopylov,0,2,0,3,5
roman kopylov ,0,1,0,2,3
roman mitichyan,0,1,0,0,1
roman mitichyan ,0,0,0,1,1
roman salazar,0,2,0,0,2
roman salazar ,0,0,1,0,1
romie aram,0,1,0,0,1
ron faircloth,0,0,1,0,1
ron stallings,0,2,0,0,2
ron stallings ,0,0,0,1,1
ron van clief,0,1,0,0,1
ron waterman,1,1,0,0,2
ron waterman ,0,0,0,2,2
ronald jhun,0,1,0,0,1
ronaldo rodriguez ,0,0,0,2,2
ronda rousey,0,1,0,0,1
ronda rousey ,0,1,0,6,7
rong zhu,0,1,0,0,1
rong zhu ,0,1,0,1,2
rongzhu ,0,1,0,0,1
ronnie lawrence,0,0,1,2,3
ronnie lawrence ,0,1,0,0,1
ronny markes,0,0,0,1,1
ronny markes ,0,2,0,2,4
rony jason,0,1,0,1,2
rony jason ,0,3,1,3,7
ronys torres,0,2,0,0,2
roosevelt roberts,0,3,0,1,4
roosevelt roberts ,0,2,1,3,6
roque martinez,0,3,0,0,3
rory macdonald,0,2,0,2,4
rory macdonald ,0,2,0,7,9
rory markham,0,2,0,0,2
rory markham ,0,0,0,1,1
rory singer,0,2,0,0,2
rory singer ,0,0,0,2,2
rose namajunas,0,3,0,4,7
rose namajunas ,0,3,0,7,10
rosi sexton,0,1,0,0,1
rosi sexton ,0,1,0,0,1
ross pearson,0,4,0,3,7
ross pearson ,0,9,1,9,19
ross pointon,0,2,0,0,2
rostem akman,0,1,0,0,1
rostem akman ,0,1,0,0,1
rousimar palhares,0,3,0,1,4
rousimar palhares ,0,1,0,7,8
roxanne modafferi,0,2,0,0,2
roxanne modafferi ,0,6,0,4,10
roy nelson,0,5,0,2,7
roy nelson ,0,5,0,7,12
royce alger,0,2,0,0,2
royce gracie,0,1,0,0,1
royce gracie ,0,0,0,8,8
royston wee,0,1,0,1,2
royston wee ,0,0,0,1,1
ruan potts,0,2,0,0,2
ruan potts ,0,1,0,0,1
rudyard moncayo,0,1,0,0,1
ruslan magomedov,0,0,0,2,2
ruslan magomedov ,0,0,0,1,1
russell doane,0,3,0,3,6
russell doane ,0,2,0,0,2
rustam khabilov,0,1,0,4,5
rustam khabilov ,0,2,0,6,8
ryan bader,0,5,0,3,8
ryan bader ,0,0,0,12,12
ryan benoit,0,5,0,1,6
ryan benoit ,0,1,0,2,3
ryan couture ,0,2,0,0,2
ryan hall,0,0,0,4,4
ryan hall ,0,1,0,1,2
ryan janes,0,2,0,2,4
ryan jensen,0,6,0,1,7
ryan jensen ,0,0,0,1,1
ryan jimmo,0,4,0,1,5
ryan jimmo ,0,0,0,2,2
ryan laflare,0,1,0,4,5
ryan laflare ,0,2,0,3,5
ryan loder,0,0,0,1,1
ryan macdonald,0,1,0,0,1
ryan macdonald ,0,1,0,0,1
ryan madigan,0,1,0,0,1
ryan mcgillivray ,0,1,0,0,1
ryan parker,0,1,0,0,1
ryan roberts,0,1,0,0,1
ryan spann,0,3,0,4,7
ryan spann ,0,1,0,4,5
ryan thomas,0,2,0,0,2
ryo chonan,0,3,0,0,3
ryo chonan ,0,0,0,1,1
sabah homasi,0,1,0,0,1
sabah homasi ,0,2,0,0,2
sabina mazo,0,1,0,0,1
sabina mazo ,0,3,0,3,6
saeed hosseini,0,1,0,0,1
sage northcutt,0,0,0,1,1
sage northcutt ,0,2,0,5,7
sai wang ,0,1,0,1,2
said nurmagomedov,0,1,0,4,5
said nurmagomedov ,0,1,0,2,3
saidyokub kakhramonov,0,1,0,2,3
saimon oliveira,0,1,0,0,1
saimon oliveira ,0,1,0,0,1
sako chivitchian ,0,1,0,0,1
salim touahri,0,2,0,0,2
salim touahri ,0,1,0,0,1
sam adkins,0,2,0,0,2
sam adkins ,0,0,0,2,2
sam alvey,1,6,0,6,13
sam alvey ,0,7,0,4,11
sam fulton,0,2,0,0,2
sam hoger,0,3,0,0,3
sam hoger ,0,0,0,2,2
sam hughes,0,5,0,4,9
sam patterson,0,0,0,1,1
sam patterson ,0,1,0,1,2
sam sicilia,0,5,0,3,8
sam sicilia ,0,2,0,2,4
sam stout,0,6,0,1,7
sam stout ,0,5,0,8,13
sammy morgan,0,2,0,0,2
samy schiavo,0,2,0,0,2
sanae kikuta ,0,0,0,1,1
santiago ponzinibbio,0,2,0,4,6
santiago ponzinibbio ,0,5,0,7,12
saparbeg safarov,0,3,0,1,4
sara mcmann,0,3,0,0,3
sara mcmann ,0,3,0,7,10
sarah alpar,0,2,0,0,2
sarah frota,0,2,0,0,2
sarah kaufman,0,1,0,0,1
sarah kaufman ,0,1,1,1,3
sarah moras,0,3,0,1,4
sarah moras ,0,3,0,2,5
sasha palatnikov,0,1,0,1,2
sasha palatnikov ,0,1,0,0,1
satoshi honma,0,1,0,0,1
scott adams ,0,0,0,1,1
scott askham,0,2,0,0,2
scott askham ,0,2,0,2,4
scott baker,0,1,0,0,1
scott bessac,0,1,0,0,1
scott bessac ,0,0,0,1,1
scott ferrozzo,0,2,0,0,2
scott ferrozzo ,0,0,0,3,3
scott fiedler,0,1,0,0,1
scott holtzman,0,3,0,2,5
scott holtzman ,0,3,0,5,8
scott jorgensen,0,5,0,0,5
scott jorgensen ,0,3,0,4,7
scott junk,0,1,0,0,1
scott morris,0,1,0,0,1
scott morris ,0,0,0,1,1
scott smith,0,3,0,0,3
scott smith ,0,0,0,1,1
sean alvarez,0,1,0,0,1
sean brady,0,1,0,3,4
sean brady ,0,0,0,4,4
sean daugherty,0,1,0,0,1
sean gannon,0,1,0,0,1
sean mccorkle,0,1,0,1,2
sean mccorkle ,0,1,0,0,1
sean o'connell,0,5,0,2,7
sean o'malley,0,0,1,4,5
sean o'malley ,0,2,0,6,8
sean pierson,0,2,0,2,4
sean pierson ,0,0,0,2,2
sean salmon,0,2,0,0,2
sean sharaf,0,1,0,0,1
sean sherk,0,4,0,0,4
sean sherk ,0,0,0,8,8
sean soriano,0,4,0,0,4
sean soriano ,0,1,0,0,1
sean spencer,0,4,0,2,6
sean spencer ,0,1,0,1,2
sean strickland,0,4,0,10,14
sean strickland ,0,2,0,6,8
sean woodson,0,0,0,3,3
sean woodson ,1,1,0,4,6
sedriques dumas,0,1,0,1,2
sedriques dumas ,0,1,0,1,2
semmy schilt,0,1,0,0,1
semmy schilt ,0,0,0,1,1
seo hee ham,0,2,0,0,2
seo hee ham ,0,1,0,1,2
sergei pavlovich,0,1,0,4,5
sergei pavlovich ,0,2,0,2,4
sergey khandozhko,0,1,0,2,3
sergey morozov,0,2,0,2,4
sergey morozov ,0,0,0,1,1
serghei spivac,0,4,0,6,10
serghei spivac ,0,0,0,2,2
sergio moraes,0,4,0,1,5
sergio moraes ,1,1,0,7,9
sergio pettis,0,3,0,5,8
sergio pettis ,0,2,0,4,6
serhiy sidey ,0,1,0,1,2
seth baczynski,0,3,0,3,6
seth baczynski ,0,3,0,2,5
seth petruzelli,0,2,0,0,2
seth petruzelli ,0,2,0,0,2
seungguk choi ,0,1,0,0,1
seungwoo choi,0,5,0,1,6
seungwoo choi ,0,1,0,2,3
shamar bailey,0,2,0,1,3
shamil abdurakhimov,0,2,0,4,6
shamil abdurakhimov ,0,4,0,1,5
shamil gamzatov ,0,1,0,1,2
shamil gaziev,0,1,0,1,2
shamil gaziev ,0,0,0,1,1
shana dobson,0,2,0,2,4
shana dobson ,0,2,0,0,2
shane burgos,0,2,0,2,4
shane burgos ,0,1,0,6,7
shane campbell,0,3,0,0,3
shane campbell ,0,1,0,1,2
shane carwin,0,1,0,1,2
shane carwin ,0,1,0,3,4
shane del rosario,0,2,0,0,2
shane howell,0,2,0,0,2
shane nelson,0,2,0,0,2
shane nelson ,0,0,0,2,2
shane primm,0,1,0,0,1
shane roller,0,3,0,2,5
shane roller ,0,1,0,0,1
shane young,0,1,0,1,2
shane young ,0,4,0,1,5
shanna young,0,3,0,1,4
shannon gugerty,0,3,0,0,3
shannon gugerty ,0,0,0,2,2
shannon ross,0,1,0,0,1
shannon ross ,0,2,0,0,2
shara magomedov ,0,0,0,2,2
shauna bannon ,0,1,0,1,2
shavkat rakhmonov,0,0,0,3,3
shavkat rakhmonov ,0,0,0,4,4
shawn jordan,0,3,0,3,6
shawn jordan ,0,1,0,3,4
shayilan nuerdanbieke,0,2,0,1,3
shayilan nuerdanbieke ,0,1,0,2,3
shayna baszler,0,2,0,0,2
sheila gaff,0,2,0,0,2
sheldon westcott,0,1,0,0,1
sheldon westcott ,0,1,0,1,2
sherman pendergarst,0,1,0,0,1
sheymon moraes,0,3,0,2,5
shi ming ,0,0,0,1,1
shinsho anzai,0,1,0,0,1
shinsho anzai ,0,1,0,2,3
shonie carter,0,3,0,0,3
shonie carter ,0,0,0,3,3
shunichi shimizu,0,1,0,0,1
sijara eubanks,0,2,0,1,3
sijara eubanks ,0,3,0,4,7
silvana gomez juarez,0,2,0,1,3
silvana gomez juarez ,0,1,0,0,1
simeon thoresen,0,1,0,0,1
simeon thoresen ,0,1,0,1,2
sione latu ,0,0,0,1,1
sirwan kakai,0,1,0,1,2
siyar bahadurzada,0,3,0,2,5
siyar bahadurzada ,0,1,0,2,3
soa palelei,0,2,0,1,3
soa palelei ,0,1,0,3,4
sodiq yusuff,0,1,0,3,4
sodiq yusuff ,0,2,0,3,5
solomon hutcherson,0,1,0,0,1
song kenan,0,1,0,1,2
song kenan ,0,4,0,4,8
song yadong,1,2,0,3,6
song yadong ,0,1,0,7,8
spencer fisher,0,7,0,0,7
spencer fisher ,0,1,0,9,10
spike carlyle,0,1,0,1,2
spike carlyle ,0,1,0,0,1
stanislav nedkov,0,2,1,1,4
stefan sekulic,0,2,0,0,2
stefan struve,0,5,0,2,7
stefan struve ,0,6,0,11,17
stephan bonnar,0,7,0,1,8
stephan bonnar ,0,0,0,7,7
stephanie egger,0,3,0,1,4
stephanie egger ,0,1,0,2,3
stephanie luciano ,0,0,0,1,1
stephen bass,0,1,0,0,1
stephen thompson,1,4,0,7,12
stephen thompson ,0,4,0,5,9
steve berger,0,2,1,0,3
steve bosse,0,1,0,1,2
steve bosse ,0,0,0,1,1
steve bruno,0,2,0,0,2
steve bruno ,0,0,0,1,1
steve byrnes,0,1,0,0,1
steve cantwell,0,3,0,0,3
steve cantwell ,0,2,0,1,3
steve erceg,0,2,0,2,4
steve erceg ,0,0,0,1,1
steve garcia,0,2,0,2,4
steve garcia ,0,0,0,4,4
steve jennum,0,1,0,0,1
steve jennum ,0,0,0,2,2
steve judson,0,2,0,0,2
steve kennedy,0,2,0,0,2
steve lopez,0,1,0,0,1
steve lopez ,0,1,0,0,1
steve montgomery,0,1,0,0,1
steve montgomery ,0,1,0,0,1
steve nelmark,0,1,0,0,1
steve nelmark ,0,0,0,2,2
steve steinbeiss,0,2,0,0,2
steve vigneault,0,1,0,0,1
steven graham,0,1,0,0,1
steven graham ,0,0,0,1,1
steven koslow,0,1,0,0,1
steven nguyen,0,1,0,0,1
steven peterson,0,3,0,3,6
steven peterson ,0,2,0,0,2
steven siler,0,2,0,2,4
steven siler ,0,2,0,3,5
stevie lynch,0,1,0,0,1
stevie ray,0,1,0,4,5
stevie ray ,0,3,0,3,6
stewart nicoll ,0,1,0,0,1
stipe miocic,0,3,0,4,7
stipe miocic ,0,2,0,10,12
sultan aliev,0,2,0,1,3
sultan aliev ,0,0,0,1,1
suman mokhtarian,0,1,0,0,1
suman mokhtarian ,0,1,0,0,1
sumudaerji ,0,1,0,3,4
sung bin jo,0,1,0,0,1
suyoung you,0,0,0,1,1
syuri kondo,0,3,0,0,3
syuri kondo ,0,0,0,1,1
tabatha ricci,0,2,0,3,5
tabatha ricci ,0,1,0,3,4
tae hyun bang,0,2,0,1,3
tae hyun bang ,0,1,0,1,2
tafon nchukwi,0,3,0,1,4
tafon nchukwi ,0,1,0,1,2
tagir ulanbekov,0,1,0,1,2
tagir ulanbekov ,0,0,0,3,3
tai bowden,0,1,0,0,1
tai bowden ,0,0,0,1,1
tai tuivasa,0,2,0,5,7
tai tuivasa ,0,6,0,3,9
taila santos,0,2,0,4,6
tainara lisboa,0,0,0,1,1
tainara lisboa ,0,0,0,1,1
takanori gomi,0,6,0,1,7
takanori gomi ,0,3,0,3,6
takashi sato,0,4,0,1,5
takashi sato ,0,1,0,1,2
takenori sato,0,2,0,0,2
takeya mizugaki,0,4,0,0,4
takeya mizugaki ,0,2,0,8,10
talita alencar,0,1,0,1,2
talita bernardo,0,1,0,1,2
talita bernardo ,0,2,0,0,2
tamdan mccrory,0,4,0,1,5
tamdan mccrory ,0,1,0,3,4
tamires vidal,0,1,0,0,1
tamires vidal ,0,2,0,1,3
tanner boser,0,2,0,2,4
tanner boser ,0,3,0,3,6
tarec saffiedine,0,2,0,0,2
tarec saffiedine ,0,2,0,2,4
tateki matsuda,0,1,0,0,1
tateki matsuda ,0,1,0,0,1
tatiana suarez,0,0,0,3,3
tatiana suarez ,0,0,0,4,4
tatsuro taira,0,1,0,1,2
tatsuro taira ,0,0,0,5,5
tatsuya kawajiri,0,3,0,1,4
tatsuya kawajiri ,0,0,0,2,2
taylor lapilus,0,2,0,1,3
taylor lapilus ,0,0,0,5,5
te edwards,0,1,0,0,1
te edwards ,0,1,0,0,1
tecia pennington,0,1,0,1,2
tecia torres,0,4,0,0,4
tecia torres ,0,2,0,9,11
tedd williams,0,1,0,0,1
tedd williams ,0,0,0,1,1
teemu packalen,0,3,0,0,3
teemu packalen ,0,0,0,1,1
tereza bleda,0,1,0,0,1
tereza bleda ,0,0,0,1,1
terrance mckinney,0,3,0,1,4
terrance mckinney ,0,1,0,4,5
terrence mitchell,0,2,0,0,2
terrion ware,0,4,0,0,4
terry etim,0,3,0,0,3
terry etim ,0,2,0,6,8
terry martin,0,4,0,0,4
terry martin ,0,0,0,2,2
teruto ishihara,1,2,0,1,4
teruto ishihara ,0,3,0,2,5
thaddeus luster,0,1,0,0,1
thales leites,0,5,0,2,7
thales leites ,0,3,0,11,14
themba gorimbo,0,2,0,1,3
themba gorimbo ,0,0,0,3,3
thiago alves,0,7,0,1,8
thiago alves ,0,5,0,14,19
thiago moises,0,4,0,3,7
thiago moises ,0,2,0,4,6
thiago perpetuo ,0,2,0,1,3
thiago santos,0,5,0,5,10
thiago santos ,0,5,0,9,14
thiago silva,0,3,1,0,4
thiago silva ,0,0,1,7,8
thiago tavares,0,4,0,1,5
thiago tavares ,1,3,0,9,13
thibault gouti,0,4,0,0,4
thibault gouti ,0,1,0,1,2
thomas almeida,0,2,0,2,4
thomas almeida ,0,3,0,3,6
thomas gifford,0,2,0,0,2
thomas petersen,0,0,0,1,1
thomas petersen ,0,1,0,0,1
thomas ramirez,0,1,0,0,1
tiago dos santos e silva,0,0,0,2,2
tiago dos santos e silva ,0,2,0,0,2
tiki ghosn,0,4,0,0,4
tim boetsch,0,7,0,6,13
tim boetsch ,0,5,0,6,11
tim credeur,0,2,0,0,2
tim credeur ,0,0,0,3,3
tim elliott,0,5,0,3,8
tim elliott ,0,5,0,6,11
tim gorman,0,2,0,0,2
tim hague,0,4,0,0,4
tim hague ,0,0,0,1,1
tim kennedy,0,0,0,1,1
tim kennedy ,0,2,0,2,4
tim lajcik,0,2,0,0,2
tim lajcik ,1,0,0,0,1
tim mckenzie,0,1,0,0,1
tim means,0,6,1,6,13
tim means ,0,8,0,9,17
tim sylvia,0,4,0,0,4
tim sylvia ,0,0,0,9,9
tim williams,0,2,0,0,2
timmy cuamba,0,1,0,0,1
timmy cuamba ,0,1,0,0,1
timothy johnson,0,1,0,2,3
timothy johnson ,0,2,0,2,4
timur valiev,0,1,0,1,2
timur valiev ,0,0,1,1,2
tina lahdemaki,0,1,0,0,1
tito ortiz,1,9,0,0,10
tito ortiz ,0,2,0,15,17
tj brown,0,4,0,1,5
tj brown ,0,1,0,2,3
tj dillashaw,0,3,0,3,6
tj dillashaw ,0,2,0,10,12
tj grant,0,1,0,2,3
tj grant ,0,2,0,6,8
tj laramie,0,2,0,0,2
tj o'brien,0,2,0,0,2
tj waldburger,0,3,0,0,3
tj waldburger ,0,1,0,4,5
todd brown,0,1,0,0,1
todd brown ,0,1,0,0,1
todd butler,0,1,0,0,1
todd duffee,0,1,0,1,2
todd duffee ,0,1,1,2,4
todd medina,0,1,0,0,1
todd medina ,0,0,0,1,1
tom aspinall,0,1,0,3,4
tom aspinall ,0,0,0,5,5
tom blackledge ,0,1,0,0,1
tom breese,0,3,0,3,6
tom breese ,0,0,0,2,2
tom deblass,0,2,0,0,2
tom duquesnoy,0,0,0,1,1
tom duquesnoy ,0,1,0,1,2
tom egan,0,1,0,0,1
tom gallicchio,0,1,0,0,1
tom lawlor,0,3,0,4,7
tom lawlor ,0,2,0,2,4
tom murphy ,0,0,0,1,1
tom niinimaki,0,1,0,1,2
tom niinimaki ,0,2,0,0,2
tom nolan,0,1,0,1,2
tom nolan ,0,0,0,1,1
tom watson,0,4,0,0,4
tom watson ,0,1,0,2,3
tomasz drwal,0,2,0,0,2
tomasz drwal ,0,1,0,3,4
tommy hayden,0,2,0,0,2
tommy speer,0,2,0,0,2
tony desouza,0,3,0,0,3
tony desouza ,0,0,0,3,3
tony ferguson,0,2,0,4,6
tony ferguson ,0,7,0,11,18
tony fryklund,0,2,0,0,2
tony fryklund ,0,0,0,2,2
tony gravely,0,3,0,2,5
tony gravely ,0,1,0,2,3
tony halme,0,1,0,0,1
tony kelley,0,2,0,2,4
tony petarra,0,1,0,0,1
tony sims,0,2,0,1,3
tonya evinger,0,2,0,0,2
tonya evinger ,0,1,0,0,1
tor troeng,0,1,0,0,1
tor troeng ,0,2,0,1,3
toshiomi kazama ,0,1,0,1,2
townsend saunders,0,2,0,0,2
tra telligman,0,4,0,0,4
tra telligman ,0,0,0,1,1
tracy cortez,0,1,0,1,2
tracy cortez ,0,0,0,4,4
travis browne,1,4,0,4,9
travis browne ,0,3,0,5,8
travis fulton,0,1,0,0,1
travis fulton ,0,0,0,1,1
travis lutter,0,4,0,0,4
travis lutter ,0,0,0,2,2
travis wiuff,0,2,0,0,2
trent jenkins,0,1,0,0,1
tresean gore,0,1,0,1,2
tresean gore ,0,1,0,1,2
trevin giles,0,4,0,1,5
trevin giles ,0,3,0,6,9
trevin jones,0,2,1,1,4
trevin jones ,0,2,0,0,2
trevor peek,0,0,0,1,1
trevor peek ,0,3,0,0,3
trevor prangley,0,2,0,0,2
trevor prangley ,0,0,0,2,2
trevor smith,0,6,0,2,8
trevor smith ,0,1,0,3,4
trey ogden,0,2,0,2,4
trey ogden ,0,0,1,1,2
trey waters,0,0,0,2,2
tristan connelly,0,2,0,1,3
troy mandaloniz,0,1,0,0,1
troy mandaloniz ,0,0,0,1,1
tsuyoshi kohsaka,0,3,0,0,3
tsuyoshi kohsaka ,0,0,0,3,3
tucker lutz,0,2,0,1,3
tucker lutz ,0,1,0,0,1
tuco tokkos,0,2,0,0,2
tulio palhares ,0,0,0,1,1
tyler diamond ,0,1,0,0,1
tyler toner,0,1,0,0,1
tyron woodley,0,3,0,3,6
tyron woodley ,1,3,0,6,10
tyrone roberts ,0,0,0,1,1
tyson griffin,0,2,0,0,2
tyson griffin ,0,4,0,8,12
tyson nam,0,3,0,1,4
tyson nam ,0,2,0,2,4
tyson pedro,0,4,0,1,5
tyson pedro ,0,1,0,5,6
ulysses gomez,0,2,0,0,2
umar nurmagomedov,0,0,0,3,3
umar nurmagomedov ,0,0,0,3,3
uriah hall,0,1,0,3,4
uriah hall ,0,8,0,7,15
urijah faber,0,5,0,0,5
urijah faber ,0,2,0,11,13
uros medic,0,0,0,3,3
uros medic ,0,2,0,1,3
vagner rocha,0,2,0,1,3
vagner rocha ,0,1,0,0,1
val woodburn,0,2,0,0,2
valentina shevchenko,1,2,0,3,6
valentina shevchenko ,0,1,0,10,11
valeri ignatov,0,2,0,0,2
valerie letourneau,0,1,0,2,3
valerie letourneau ,0,2,0,1,3
valmir lazaro,0,1,0,1,2
valmir lazaro ,0,1,0,0,1
valter walker,0,0,0,1,1
valter walker ,0,1,0,0,1
vanessa demopoulos,0,3,0,1,4
vanessa demopoulos ,0,0,0,4,4
vanessa melo,0,2,0,1,3
vanessa melo ,0,1,0,0,1
vaughan lee,0,4,0,2,6
vaughan lee ,0,1,0,1,2
vernon ramos ho ,0,1,0,0,1
vernon white,0,1,0,0,1
vernon white ,1,0,0,0,1
veronica hardy,0,0,0,2,2
veronica hardy ,0,1,0,1,2
veronica macedo,0,1,0,0,1
veronica macedo ,0,3,0,1,4
viacheslav borshchev,1,3,0,2,6
viacheslav borshchev ,0,0,0,1,1
vicente luque,0,3,0,3,6
vicente luque ,0,3,0,13,16
victor altamirano,0,2,0,1,3
victor altamirano ,0,2,0,1,3
victor henry,0,2,0,2,4
victor henry ,0,0,0,1,1
victor hugo,0,0,0,1,1
victor martinez,0,1,0,0,1
victor martinez ,0,1,0,0,1
victor rodriguez,0,2,0,0,2
victor valimaki,0,2,0,0,2
victoria leonardo,0,2,0,1,3
victoria leonardo ,0,2,0,0,2
vik grujic,0,1,0,1,2
vik grujic ,0,2,0,0,2
viktor pesta,0,2,0,0,2
viktor pesta ,0,2,0,1,3
viktoriia dudakova ,0,1,0,1,2
vinc pichel,0,2,0,4,6
vinc pichel ,0,2,0,3,5
vince cachero,0,1,0,0,1
vince cachero ,0,1,0,0,1
vince morales,0,5,0,2,7
vince morales ,0,1,0,1,2
vinicius moreira,0,3,0,0,3
vinicius moreira ,0,1,0,0,1
vinicius oliveira,0,0,0,1,1
vinicius oliveira ,0,0,0,1,1
vinicius queiroz,0,1,0,0,1
vinicius salvador,0,3,0,0,3
vinny magalhaes,0,3,0,1,4
vinny magalhaes ,0,1,0,0,1
virna jandiroba,0,3,0,4,7
virna jandiroba ,0,0,0,3,3
viscardi andrade,0,0,0,1,1
viscardi andrade ,0,1,0,2,3
vitor belfort,0,8,0,0,8
vitor belfort ,0,2,1,15,18
vitor miranda,0,1,0,0,1
vitor miranda ,0,3,0,3,6
vitor petrino,0,1,0,0,1
vitor petrino ,0,1,0,4,5
viviane araujo,0,3,0,4,7
viviane araujo ,0,2,0,3,5
viviane pereira,0,1,0,1,2
viviane pereira ,0,1,0,1,2
vladimir matyushenko,0,4,0,1,5
vladimir matyushenko ,0,1,0,6,7
volkan oezdemir,0,2,0,4,6
volkan oezdemir ,0,5,0,4,9
wade shipp,0,1,0,0,1
wagner campos,0,1,0,0,1
wagner prado,0,1,1,0,2
wagner prado ,0,1,0,0,1
wagner silva,0,1,0,0,1
wagner silva ,0,1,0,0,1
waldo cortes-acosta,0,1,0,2,3
waldo cortes-acosta ,0,0,0,2,2
walel watson,0,2,0,0,2
walel watson ,0,1,0,1,2
wallid ismail,0,1,0,0,1
walt harris,0,6,1,2,9
walt harris ,0,3,0,4,7
wanderlei silva,0,5,0,0,5
wanderlei silva ,0,2,0,5,7
wang cong ,0,1,0,1,2
wang guan ,0,0,0,1,1
war machine,0,1,0,0,1
war machine ,0,0,0,1,1
warlley alves,0,2,0,2,4
warlley alves ,0,5,0,6,11
waylon lowe,0,1,0,1,2
waylon lowe ,0,1,0,1,2
wellington turman,0,4,0,3,7
wellington turman ,0,2,0,0,2
wendell oliveira marques,0,1,0,0,1
wendell oliveira marques ,0,1,0,0,1
wes albritton,0,1,0,0,1
wes combs,0,2,0,0,2
wes sims,0,3,0,0,3
wesley correira,0,2,0,0,2
wesley correira ,0,0,0,2,2
westin wilson,0,1,0,1,2
westin wilson ,0,1,0,0,1
will brooks,0,1,0,1,2
will brooks ,0,2,0,0,2
will campuzano ,0,4,0,0,4
will chope,0,1,0,0,1
willamy freire,0,1,0,0,1
william gomis,0,0,0,1,1
william gomis ,0,0,0,3,3
william knight,0,2,0,1,3
william knight ,0,2,0,2,4
william macario ,0,3,0,1,4
willie gates,0,3,0,1,4
wilson gouveia,0,4,0,0,4
wilson gouveia ,0,0,0,6,6
wilson reis,0,4,0,3,7
wilson reis ,0,2,0,4,6
wu yanan,0,1,0,0,1
wu yanan ,0,4,0,1,5
wuliji buren,0,1,0,0,1
wuliji buren ,0,2,0,0,2
xavier foupa-pokam,0,2,0,0,2
xiao long ,0,1,0,1,2
yair rodriguez,0,3,0,2,5
yair rodriguez ,0,1,1,8,10
yan cabral ,0,3,0,2,5
yan xiaonan,0,2,0,6,8
yan xiaonan ,0,1,0,3,4
yana kunitskaya,0,3,0,3,6
yana kunitskaya ,0,0,0,1,1
yana santos,0,1,0,0,1
yana santos ,0,1,0,1,2
yanal ashmouz,0,1,0,2,3
yancy medeiros,0,7,1,4,12
yancy medeiros ,0,1,0,2,3
yanis ghemmouri,0,2,0,0,2
yao zhikui,0,0,0,1,1
yao zhikui ,0,3,0,0,3
yaotzin meza,0,3,1,2,6
yaotzin meza ,0,1,0,0,1
yasuhiro urushitani,0,1,0,0,1
yasuhiro urushitani ,0,1,0,0,1
yazmin jauregui ,0,2,0,3,5
yi zha,0,1,0,0,1
yizha ,0,1,0,0,1
yoel romero,0,2,0,7,9
yoel romero ,0,2,0,2,4
yohan lainesse,0,2,0,1,3
yohan lainesse ,0,1,0,0,1
yoislandy izquierdo,0,2,0,0,2
yoji anjo,0,3,0,0,3
yorgan de castro,0,1,0,1,2
yorgan de castro ,0,2,0,0,2
yosdenis cedeno,0,2,0,0,2
yosdenis cedeno ,0,1,0,1,2
yoshihiro akiyama,0,3,0,0,3
yoshihiro akiyama ,0,2,0,2,4
yoshiki takahashi ,0,0,0,1,1
yoshinori horie,0,1,0,0,1
yoshiyuki yoshida,0,2,0,0,2
yoshiyuki yoshida ,0,1,0,2,3
youssef zalal,0,2,0,4,6
youssef zalal ,1,1,0,2,4
yui chul nam,0,1,0,1,2
yui chul nam ,0,1,0,0,1
yuki kondo,0,2,0,0,2
yuki kondo ,0,0,0,1,1
yuki sasaki,0,1,0,0,1
yuri vaulin,0,1,0,0,1
yuri villefort,0,1,0,0,1
yuri villefort ,0,1,0,0,1
yusaku kinoshita ,0,1,0,0,1
yushin okami,0,4,0,3,7
yushin okami ,0,3,0,11,14
yusuke kasuya,0,1,0,0,1
yusuke kasuya ,0,1,0,0,1
yuta sasaki,0,5,0,3,8
yuta sasaki ,0,0,0,1,1
yves edwards,0,5,0,1,6
yves edwards ,0,5,1,9,15
yves jabouin,0,2,0,1,3
yves jabouin ,0,3,0,4,7
zabit magomedsharipov,0,0,0,2,2
zabit magomedsharipov ,0,0,0,4,4
zac pauga,0,1,0,1,2
zac pauga ,0,2,0,0,2
zach light,0,1,0,0,1
zach makovsky,0,3,0,1,4
zach makovsky ,0,1,0,2,3
zach reese,0,0,0,1,1
zach reese ,0,1,0,0,1
zachary reese ,0,0,0,1,1
zachary scroggin,0,1,0,0,1
zak cummings,0,3,0,4,7
zak cummings ,0,1,0,6,7
zak ottow,0,4,0,3,7
zak ottow ,0,0,0,1,1
zane frazier,0,1,0,0,1
zarah fairn,0,3,0,0,3
zarah fairn ,0,1,0,0,1
zarrukh adashev,0,3,0,1,4
zelim imadaev,0,2,0,0,2
zelim imadaev ,0,1,0,0,1
zhalgas zhumagulov,0,5,0,0,5
zhalgas zhumagulov ,0,1,0,1,2
zhang lipeng,0,0,0,1,1
zhang lipeng ,0,2,0,1,3
zhang mingyang ,0,0,0,2,2
zhang tiequan ,0,3,0,1,4
zhang weili,0,1,0,4,5
zhang weili ,0,1,0,5,6
zubaira tukhugov,0,2,0,3,5
zubaira tukhugov ,1,1,0,2,4
zviad lazishvili,0,1,0,0,1
zygimantas ramaska ,0,1,0,0,1
