Fighter,wins,losses,draws,nc,total_matches
aalon cruz,0,2,0,0,2
aaron brink,0,1,0,0,1
aaron phillips,0,4,0,0,4
aaron riley,3,6,0,0,9
aaron rosa,1,2,0,0,3
aaron simpson,7,4,0,0,11
aaron wilkinson,0,1,0,0,1
abdul razak alhassan,6,6,0,1,13
abdul-kareem al-selwady,0,1,0,0,1
abdul-kerim edilov,1,0,0,0,1
abel trujillo,6,4,0,1,11
abner lloveras,0,1,0,0,1
abu azaitar,1,1,0,0,2
abubakar nurmagomedov,2,2,0,0,4
abus magomedov,2,2,0,0,4
adam cella,0,1,0,0,1
adam fugitt,2,2,0,0,4
adam milstead,1,2,0,1,4
adam wieczorek,2,1,0,0,3
adam yandiev,0,1,0,0,1
adlan amagov,2,0,0,0,2
adrian serrano,0,1,0,0,1
adrian yanez,6,3,0,0,9
adriano martins,4,3,0,0,7
adriano santos,0,1,0,0,1
aiemann zahabi,6,2,0,0,8
ailin perez,4,1,0,0,5
aisling daly,2,1,0,0,3
aj cunningham,0,1,0,0,1
aj dobson,1,3,0,0,4
aj fletcher,1,3,0,0,4
akbarh arreola,1,3,0,0,4
akihiro gono,1,2,0,0,3
akira corassani,3,3,0,0,6
al iaquinta,9,6,0,0,15
alan baudot,0,4,0,0,4
alan belcher,9,6,0,0,15
alan jouban,8,5,0,0,13
alan omer,0,2,0,0,2
alan patrick,5,4,0,1,10
alatengheili,5,2,1,0,8
albert cheng,0,1,0,0,1
albert duraev,2,2,0,0,4
albert morales,1,4,1,0,6
albert tumenov,5,3,0,0,8
alberta cerra leon,0,1,0,0,1
alberto crane,0,2,0,0,2
alberto mina,3,1,0,0,4
alberto uda,0,2,0,0,2
alejandro perez,8,4,1,0,13
aleksa camur,1,3,0,0,4
aleksandar rakic,6,3,0,0,9
aleksandra albu,2,2,0,0,4
aleksei kunchenko,2,2,0,0,4
aleksei oleinik,9,8,0,0,17
alen amedovski,0,4,0,0,4
alessandro costa,2,2,0,0,4
alessio di chirico,4,7,0,0,11
alessio sakara,6,8,0,1,15
alex andrade,0,1,0,0,1
alex caceres,16,12,0,1,29
alex chambers,1,4,0,0,5
alex da silva,1,3,0,0,4
alex garcia,5,5,0,0,10
alex gorgees,0,1,0,0,1
alex hunter,2,0,0,0,2
alex karalexis,1,2,0,0,3
alex morono,13,8,0,1,22
alex nicholson,1,3,0,0,4
alex oliveira,11,10,0,1,22
alex pereira,9,1,0,0,10
alex perez,7,5,0,0,12
alex reyes,0,3,0,0,3
alex ricci,0,2,0,0,2
alex schoenauer,0,1,0,0,1
alex soto,0,2,0,0,2
alex stiebling,0,1,0,0,1
alex torres,0,1,0,0,1
alex white,4,6,0,0,10
alexa grasso,8,4,1,0,13
alexander gustafsson,10,8,0,0,18
alexander hernandez,7,7,0,0,14
alexander munoz,1,2,0,0,3
alexander volkanovski,13,2,0,0,15
alexander volkov,12,5,0,0,17
alexander yakovlev,3,6,0,0,9
alexandr romanov,7,3,0,0,10
alexandre barros,0,1,0,0,1
alexandre dantas,0,2,0,0,2
alexandre ferreira,0,1,0,0,1
alexandre pantoja,13,3,0,0,16
alexis davis,8,6,0,0,14
alexis dufresne,0,2,0,0,2
alfonso alcarez,0,0,1,0,1
ali alqaisi,0,2,0,0,2
ali bagautinov,4,3,0,0,7
aliaskhab khizriev,1,0,0,1,2
alice ardelean,0,2,0,0,2
alistair overeem,12,8,0,0,20
aljamain sterling,16,5,0,0,21
allan goes,0,1,0,0,1
allan nascimento,2,1,0,0,3
allan zuniga,0,1,0,0,1
allen berube,0,1,0,0,1
allen crowder,1,2,0,0,3
alonzo menifield,8,5,1,0,14
alptekin ozkilic,1,3,0,0,4
alvaro herrera mendoza,1,3,0,0,4
alvin robinson,1,3,0,0,4
amanda cooper,2,4,0,0,6
amanda lemos,8,4,0,0,12
amanda nunes,16,2,0,0,18
amanda ribas,7,4,0,0,11
amar suloev,0,2,0,0,2
amaury bitetti,1,1,0,0,2
amilcar alves,0,2,0,0,2
amir albazi,5,1,0,0,6
amir sadollah,6,5,0,0,11
anderson dos santos,1,3,0,0,4
anderson silva,17,7,0,1,25
andre ewell,4,5,0,0,9
andre fialho,2,5,0,0,7
andre fili,12,10,0,1,23
andre gusmao,0,2,0,0,2
andre lima,3,0,0,0,3
andre muniz,6,2,0,0,8
andre pederneiras,0,1,0,0,1
andre petroski,7,2,0,0,9
andre roberts,2,1,0,0,3
andre soukhamthath,2,5,0,0,7
andre winner,2,4,0,0,6
andrea lee,5,8,0,0,13
andreas michailidis,1,3,0,0,4
andreas stahl,0,2,0,0,2
andrei arlovski,23,18,0,1,42
andrei semenov,1,1,0,0,2
andrew craig,3,4,0,0,7
andrew holbrook,2,3,0,0,5
andrew sanchez,5,5,0,0,10
andy anderson,0,1,0,0,1
andy enz,0,3,0,0,3
andy ogle,1,5,0,0,6
andy wang,0,1,0,0,1
ange loosa,2,2,0,1,5
angel pacheco,0,1,0,0,1
angela hill,12,14,0,0,26
angela magana,0,3,0,0,3
anistavio medeiros,0,1,0,0,1
anna elmose,0,2,0,0,2
ansar chalangov,0,2,0,0,2
anshul jubli,1,0,0,0,1
anthony birchak,2,4,0,0,6
anthony christodoulou,0,2,0,0,2
anthony hamilton,3,7,0,0,10
anthony hernandez,7,2,0,0,9
anthony ivy,0,2,0,0,2
anthony johnson,13,6,0,0,19
anthony lapsley,0,2,0,0,2
anthony macias,1,2,0,0,3
anthony njokuani,3,5,0,0,8
anthony perosh,5,7,0,0,12
anthony pettis,11,9,0,0,20
anthony rocco martin,9,6,0,0,15
anthony smith,12,11,0,0,23
anthony torres,1,1,0,0,2
anton kuivanen,1,2,0,0,3
anton turkalj,0,4,0,0,4
anton zafir,0,2,0,0,2
antoni hardonk,4,4,0,0,8
antonina shevchenko,4,4,0,0,8
antonio arroyo,0,3,0,0,3
antonio banuelos,0,1,0,0,1
antonio braga neto,1,2,0,0,3
antonio carlos junior,7,5,0,1,13
antonio carvalho,2,2,0,0,4
antonio dos santos,0,2,0,0,2
antonio mckee,0,1,0,0,1
antonio mendes,0,2,0,0,2
antonio rodrigo nogueira,5,6,0,0,11
antonio silva,3,7,1,0,11
antonio trocoli,0,2,0,0,2
anying wang,1,1,0,0,2
aoriqileng,3,4,0,1,8
ariane carnelossi,3,2,0,0,5
ariane da silva,0,2,0,0,2
ariane lipski,6,5,0,0,11
ariel beck,0,1,0,0,1
arjan bhullar,3,1,0,0,4
arman tsarukyan,9,2,0,0,11
armen petrosyan,3,2,0,0,5
arnold allen,11,2,0,0,13
artem lobov,2,5,0,0,7
asbel cancio,0,1,0,0,1
ashkan mokhtarian,0,2,0,0,2
ashlee evans-smith,3,6,0,0,9
ashley yoder,3,8,0,0,11
askar askarov,3,1,1,0,5
askar mozharov,0,1,0,0,1
aspen ladd,4,3,0,0,7
assu almabayev,1,0,0,0,1
assuerio silva,0,3,0,0,3
asu almabayev,3,0,0,0,3
augusto mendes,1,2,0,0,3
augusto montano,1,2,0,0,3
augusto sakai,5,4,0,0,9
austen lane,1,2,0,1,4
austin arnett,1,3,0,0,4
austin hubbard,4,6,0,0,10
austin lingo,2,3,0,0,5
austin springer,0,1,0,0,1
azamat gashimov,0,2,0,0,2
azamat murzakanov,4,0,0,0,4
azat maksum,1,1,0,0,2
azunna anyanwu,0,1,0,0,1
baergeng jieleyisi,0,1,0,0,1
barb honchak,0,2,0,0,2
bart palaszewski,1,3,0,0,4
bartosz fabinski,3,3,0,0,6
bas rutten,2,0,0,0,2
bassil hafez,1,2,0,0,3
batgerel danaa,0,3,0,0,3
bea malecki,2,1,0,0,3
bec rawlings,2,5,0,0,7
bekzat almakhan,0,1,0,0,1
belal muhammad,15,3,0,1,19
ben alloway,1,2,0,0,3
ben askren,1,2,0,0,3
ben earwood,1,0,0,0,1
ben nguyen,4,3,0,0,7
ben rothwell,9,8,0,0,17
ben saunders,9,10,0,0,19
ben sosoli,0,1,0,1,2
ben wall,0,2,0,0,2
benardo sopaj,0,1,0,0,1
beneil dariush,16,6,1,0,23
benito lopez,2,2,0,0,4
benji radach,1,1,0,1,3
benoit saint denis,5,3,0,0,8
benson henderson,11,3,0,0,14
bentley syler,0,1,0,0,1
bernardo magalhaes,0,2,0,0,2
besam yousef,0,2,0,0,2
bethe correia,5,6,1,0,12
bevon lewis,1,3,0,0,4
bharat kandare,0,1,0,0,1
bibulatov magomed,1,2,0,0,3
bill algeo,5,5,0,0,10
bill mahood,0,1,0,0,1
billy miles,0,1,0,0,1
billy quarantillo,6,5,0,0,11
billy ray goff,0,1,0,0,1
bj penn,12,13,2,0,27
blagoy ivanov,3,5,0,0,8
blake bilder,1,2,0,0,3
blood diamond,0,3,0,0,3
bo nickal,4,0,0,0,4
bob cook,1,0,0,0,1
bob gilstrap,0,1,0,0,1
bobby green,13,10,1,1,25
bobby hoffman,0,2,0,1,3
bobby moffett,0,2,0,1,3
bobby nash,0,3,0,0,3
bobby southworth,0,1,0,0,1
bobby voelker,0,4,0,0,4
bogdan guskov,2,1,0,0,3
bojan mihajlovic,0,3,0,0,3
bojan velickovic,2,3,1,0,6
bolaji oki,1,1,0,0,2
boston salmon,0,2,0,0,2
brad blackburn,3,2,0,0,5
brad gumm,0,1,1,0,2
brad imes,0,3,0,0,3
brad katona,4,4,0,0,8
brad kohler,1,1,0,0,2
brad morris,0,2,0,0,2
brad pickett,5,9,0,0,14
brad riddell,4,3,0,0,7
brad scott,3,5,0,0,8
brad tavares,15,10,0,0,25
brady hiestand,3,1,0,0,4
branden lee hinkle,1,2,0,0,3
brandon davis,2,7,0,0,9
brandon jenkins,0,2,0,0,2
brandon melendez,0,1,0,0,1
brandon moreno,10,5,2,0,17
brandon royval,7,3,0,0,10
brandon thatch,2,4,0,0,6
brandon vera,8,7,0,1,16
brandon wolff,0,2,0,0,2
braxton smith,0,1,0,0,1
brendan allen,12,3,0,0,15
brendan loughnane,0,1,0,0,1
brendan o'reilly,1,3,0,0,4
brendan schaub,6,5,0,0,11
brendon marotte,0,2,0,0,2
brendson ribeiro,1,2,0,0,3
brett johns,5,2,0,0,7
brian bowles,2,2,0,0,4
brian camozzi,0,3,0,0,3
brian cobb,0,1,0,0,1
brian ebersole,5,3,0,0,8
brian foster,3,2,0,0,5
brian gassaway,0,1,0,0,1
brian geraghty,0,1,0,0,1
brian houston,0,2,0,0,2
brian johnston,2,4,0,0,6
brian kelleher,8,9,0,0,17
brian melancon,1,1,0,0,2
brian ortega,8,4,0,1,13
brian stann,6,5,0,0,11
brianna van buren,1,1,0,0,2
bristol marunde,0,2,0,0,2
brock jardine,0,2,0,0,2
brock larson,3,3,0,0,6
brock lesnar,4,3,0,1,8
brodie farber,0,2,0,0,2
brogan walker,0,2,0,0,2
brok weaver,1,2,0,0,3
bruna brasil,2,2,0,0,4
brunno ferreira,3,1,0,0,4
bruno korea,0,1,0,0,1
bruno santos,1,2,0,0,3
bruno silva,8,7,0,1,16
bruno souza,0,2,0,0,2
bryan barberena,9,10,0,0,19
bryan battle,7,1,0,1,9
bryan caraway,6,4,0,0,10
bryce mitchell,8,2,0,0,10
bubba bush,0,1,0,1,2
buddy roberts,1,1,0,0,2
byron bloodworth,0,2,0,0,2
cain carrizosa,0,2,0,0,2
cain velasquez,12,3,0,0,15
caio borralho,7,0,0,0,7
caio machado,0,3,0,0,3
caio magalhaes,4,3,0,0,7
cal worsham,1,2,0,0,3
cale yarbrough,0,1,0,0,1
callan potter,1,2,0,0,3
calvin kattar,7,6,0,0,13
cameron dollar,0,1,0,0,1
cameron else,0,2,0,0,2
cameron saaiman,3,2,0,0,5
cameron smotherman,1,0,0,0,1
cameron vancamp,0,2,0,0,2
caol uno,3,5,2,0,10
caolan loughran,1,2,0,0,3
carl deaton,0,2,0,0,2
carla esparza,10,6,0,0,16
carli judice,0,1,0,0,1
carlo pedersoli jr.,1,2,0,0,3
carlo prater,1,2,0,0,3
carlos barreto,0,1,0,0,1
carlos candelario,0,2,0,0,2
carlos condit,9,10,0,0,19
carlos eduardo rocha,1,2,0,0,3
carlos felipe,3,2,0,0,5
carlos hernandez,3,3,0,0,6
carlos huachin,0,2,0,0,2
carlos mota,0,1,0,0,1
carlos newton,3,4,0,0,7
carlos prates,4,0,0,0,4
carlos ulberg,7,1,0,0,8
carlos vera,0,1,0,0,1
carls john de tomas,0,2,0,0,2
carlston harris,4,2,0,0,6
carlton minus,0,2,0,0,2
carmelo marrero,1,3,0,0,4
caros fodor,0,1,0,0,1
casey kenney,5,3,0,0,8
casey o'neill,5,2,0,0,7
cat zingano,3,4,0,0,7
cathal pendred,4,2,0,0,6
cb dollaway,11,9,0,0,20
cesar almeida,2,1,0,0,3
cesar arzamendia,0,2,0,0,2
cesar marscucci,1,0,0,0,1
cezar ferreira,9,6,0,0,15
chad anheliger,2,3,0,0,5
chad griggs,0,2,0,0,2
chad laprise,6,4,0,0,10
chad mendes,9,5,0,0,14
chad reiner,0,2,0,0,2
chael sonnen,7,7,0,0,14
chan sung jung,7,4,0,0,11
chan-mi jeon,0,2,0,0,2
chance rencountre,2,2,0,0,4
changho lee,1,0,0,0,1
charalampos grigoriou,0,2,0,0,2
charles byrd,1,3,0,0,4
charles johnson,6,4,0,0,10
charles jourdain,7,7,1,0,15
charles mccarthy,1,2,0,0,3
charles oliveira,23,10,0,1,34
charles radtke,3,1,0,0,4
charles rosa,5,8,0,0,13
charlie brenneman,4,7,0,0,11
charlie campbell,2,0,0,0,2
charlie ontiveros,0,3,0,0,3
charlie valencia,0,1,0,0,1
charlie ward,0,2,0,0,2
chas skelly,8,3,0,1,12
chase gormley,0,2,0,0,2
chase hooper,7,3,0,0,10
chase sherman,4,11,0,0,15
che mills,2,1,0,1,4
cheick kongo,11,6,1,0,18
chelsea chandler,2,2,0,0,4
chepe mariscal,4,0,0,0,4
cheyanne vlismas,2,2,0,0,4
chico camus,3,4,0,1,8
chidi njokuani,4,2,0,0,6
chris avila,0,2,0,0,2
chris barnett,2,2,0,0,4
chris beal,2,3,0,0,5
chris brennan,1,2,0,0,3
chris camozzi,9,10,0,0,19
chris cariaso,7,6,0,0,13
chris clements,2,2,0,1,5
chris condo,0,1,0,0,1
chris cope,1,2,0,0,3
chris curtis,5,3,0,1,9
chris daukaus,4,4,0,0,8
chris de la rocha,1,3,0,0,4
chris dempsey,1,3,0,0,4
chris duncan,3,1,0,0,4
chris fishgold,1,3,0,0,4
chris gruetzemacher,3,4,0,0,7
chris gutierrez,9,3,1,0,13
chris haseman,0,1,0,0,1
chris heatherly,0,2,0,0,2
chris holdsworth,2,0,0,0,2
chris indich,0,2,0,0,2
chris kelades,2,2,0,0,4
chris leben,12,10,0,0,22
chris liguori,0,1,0,0,1
chris lytle,10,10,0,0,20
chris padilla,2,0,0,0,2
chris price,0,2,0,0,2
chris sanford,0,1,0,0,1
chris saunders,0,1,0,0,1
chris spang,0,1,0,0,1
chris tickle,0,1,0,0,1
chris tuchscherer,1,3,0,0,4
chris wade,5,2,0,0,7
chris weidman,12,8,0,0,20
chris wilson,1,3,0,0,4
christian aguilera,1,2,0,0,3
christian colombo,0,2,1,0,3
christian duncan,1,0,0,0,1
christian leroy duncan,2,2,0,0,4
christian morecraft,1,3,0,0,4
christian rodriguez,4,2,0,0,6
christian wellisch,2,3,0,0,5
christina marks,0,1,0,0,1
christophe leninger,0,2,0,0,2
christos giagos,6,8,0,0,14
chuck liddell,16,7,0,0,23
chuck o'neil,0,1,0,0,1
cindy dandois,0,1,0,0,1
ciryl gane,10,2,0,0,12
cj fernandes,0,0,1,0,1
cj keith,0,2,0,0,2
cj vergara,3,4,0,0,7
claude patrick,3,1,0,0,4
claudia gadelha,7,5,0,0,12
claudio puelles,5,3,0,0,8
claudio ribeiro,1,3,0,0,4
claudio silva,5,3,0,0,8
clay collard,1,3,0,0,4
clay guida,18,19,0,0,37
clay harvison,1,2,0,0,3
clayton carpenter,2,0,0,0,2
clifford starks,1,2,0,0,3
clint hester,4,3,0,0,7
cm punk,0,1,0,1,2
cody brundage,4,5,0,1,10
cody donovan,1,3,0,0,4
cody durden,6,5,1,0,12
cody east,0,2,0,0,2
cody garbrandt,9,6,0,0,15
cody gibson,3,5,0,0,8
cody haddon,1,0,0,0,1
cody mckenzie,3,4,0,0,7
cody pfister,1,3,0,0,4
cody stamann,7,7,1,0,15
colby covington,12,5,0,0,17
cole escovedo,0,3,0,0,3
cole miller,10,9,0,1,20
cole smith,1,2,0,0,3
cole williams,0,2,0,0,2
colin fletcher,0,2,0,0,2
colin robinson,0,2,0,0,2
collin anglin,0,2,0,0,2
collin hart,0,1,0,0,1
colton smith,1,3,0,0,4
connor matthews,0,1,0,0,1
conor mcgregor,10,4,0,0,14
constantinos philippou,6,4,0,0,10
corey anderson,10,5,0,0,15
corey hill,1,2,0,0,3
cortavious romious,0,1,0,0,1
cortney casey,6,9,0,0,15
cory hendricks,0,1,0,0,1
cory mckenna,3,3,0,0,6
cory sandhagen,10,4,0,0,14
cory walmsley,0,1,0,0,1
court mcgee,11,12,0,0,23
courtney turner,0,1,0,0,1
crafton wallace,0,2,0,0,2
craig white,0,2,0,0,2
cristian quinonez,1,2,0,0,3
cristiane justino,6,1,0,0,7
cristiano marcello,1,3,0,0,4
cristina stanciu,0,2,0,0,2
cub swanson,15,10,0,0,25
cung le,2,2,0,0,4
curt warburton,1,2,0,0,3
curtis blaydes,13,5,0,1,19
curtis millender,3,2,0,0,5
curtis stout,0,2,0,0,2
cynthia calvillo,6,6,1,0,13
cyril asker,2,3,0,0,5
cyrille diabate,4,4,0,0,8
da woon jung,0,4,0,0,4
da'mon blackshear,3,3,1,0,7
da-un jung,4,0,1,0,5
daichi abe,1,2,0,0,3
daiju takase,0,3,0,0,3
dakota bush,0,2,0,0,2
dalcha lungiambula,2,5,0,0,7
dale hartt,1,2,0,0,3
damacio page,0,3,0,0,3
damarques johnson,4,6,0,0,10
damian grabowski,0,3,0,0,3
damian stasiak,2,4,0,0,6
damien brown,2,4,0,0,6
damir hadzovic,4,5,0,0,9
damir ismagulov,5,2,0,0,7
damon jackson,6,6,1,1,14
dan argueta,1,4,0,1,6
dan barrera,0,1,0,0,1
dan bobish,1,1,0,0,2
dan christison,1,1,0,0,2
dan cramer,1,1,0,0,2
dan evensen,0,2,0,0,2
dan hardy,6,4,0,0,10
dan henderson,9,9,0,0,18
dan hooker,14,8,0,0,22
dan ige,10,7,0,0,17
dan lauzon,0,3,0,0,3
dan miller,6,7,0,0,13
dan moret,0,3,0,0,3
dan severn,8,3,0,0,11
dan stittgen,0,2,0,0,2
danaa batgerel,3,1,0,0,4
daniel barez,1,1,0,0,2
daniel cormier,11,3,0,1,15
daniel da silva,0,3,0,0,3
daniel jolly,0,2,0,0,2
daniel kelly,6,4,0,0,10
daniel lacerda,0,2,0,1,3
daniel marcos,4,0,0,1,5
daniel omielanczuk,4,5,0,0,9
daniel pineda,5,8,0,1,14
daniel roberts,3,4,0,0,7
daniel rodriguez,8,4,0,0,12
daniel santos,2,1,0,0,3
daniel sarafian,2,4,0,0,6
daniel spitz,1,3,0,0,4
daniel spohn,0,1,0,0,1
daniel teymur,1,4,0,0,5
daniel zellhuber,3,2,0,0,5
danielle taylor,2,3,0,0,5
danillo villefort,0,1,0,0,1
danilo belluardo,0,2,0,0,2
danilo marques,2,2,0,0,4
danny abbadi,0,2,0,0,2
danny barlow,2,0,0,0,2
danny castillo,7,7,0,0,14
danny chavez,1,2,1,0,4
danny downes,0,2,0,0,2
danny henry,2,2,0,0,4
danny martinez,1,3,0,0,4
danny mitchell,0,2,0,0,2
danny roberts,7,7,0,0,14
danny silva,1,0,0,0,1
dante rivera,0,1,0,0,1
danyelle wolf,0,1,0,0,1
daria zhelezniakova,1,1,0,0,2
darian weeks,0,3,0,0,3
darko stosic,1,3,0,0,4
daron cruickshank,6,6,0,1,13
darrel gholar,0,1,0,0,1
darrell horcher,1,3,0,0,4
darrell montague,0,3,0,0,3
darren elkins,19,10,0,0,29
darren stewart,5,7,0,2,14
darren till,6,5,1,0,12
darren uyenoyama,2,2,0,0,4
darrick minner,2,4,0,0,6
darrill schoonover,0,1,0,0,1
darrius flowers,0,3,0,0,3
dashon johnson,0,2,0,0,2
dave beneteau,3,3,0,0,6
dave berry,0,1,0,0,1
dave galera,0,1,0,0,1
dave herman,1,4,0,0,5
dave menne,2,4,0,0,6
dave strasser,1,1,0,0,2
davey grant,7,6,0,0,13
davi ramos,4,3,0,0,7
david abbott,8,10,0,0,18
david baron,0,1,0,0,1
david bielkheden,1,2,0,0,3
david branch,4,5,0,0,9
david dodd,0,2,0,0,2
david dvorak,3,3,0,0,6
david heath,2,3,0,0,5
david hood,0,1,0,0,1
david kaplan,0,2,0,0,2
david lee,0,2,0,0,2
david levicki,0,1,0,0,1
david loiseau,4,5,0,0,9
david michaud,1,2,0,0,3
david mitchell,1,4,0,0,5
david onama,5,2,0,0,7
david roberts,0,1,0,0,1
david terrell,2,1,0,0,3
david teymur,5,1,0,0,6
david velasquez,0,1,0,0,1
david zawada,1,4,0,0,5
dean barry,0,1,0,0,1
dean lister,4,2,0,0,6
deanna bennett,0,0,1,0,1
deiveson figueiredo,13,4,1,0,18
delson heleno,0,1,0,0,1
demetrious johnson,15,2,1,0,18
demian maia,22,11,0,0,33
denis kang,1,2,0,0,3
denis stojnic,0,2,0,0,2
denis tiuliulin,1,5,0,0,6
denise gomes,4,2,0,0,6
dennis bermudez,10,7,0,0,17
dennis buzukja,1,3,0,0,4
dennis hallman,4,5,0,0,9
dennis siver,12,8,0,1,21
denys bondar,0,3,0,0,3
dequan townsend,0,4,0,0,4
derek brunson,14,7,0,0,21
derek downey,0,1,0,0,1
deron winn,2,3,0,0,5
derrick krantz,0,2,0,0,2
derrick lewis,19,10,0,0,29
derrick noble,0,1,0,0,1
desmond green,4,3,0,0,7
devin clark,8,9,0,0,17
devin powell,1,3,0,0,4
devonte smith,3,3,0,0,6
dhiego lima,4,7,0,0,11
diana belbita,2,5,0,0,7
diego brandao,6,4,0,0,10
diego ferreira,10,5,0,0,15
diego lopes,5,1,0,0,6
diego nunes,3,3,0,0,6
diego rivas,2,2,0,0,4
diego sanchez,19,13,0,0,32
diego saraiva,0,3,0,0,3
dieusel berto,0,1,0,0,1
dileno lopes,0,2,0,0,2
din thomas,5,4,0,0,9
dione barbosa,1,1,0,0,2
dmitri stepanov,0,1,0,0,1
dmitrii smoliakov,0,3,0,0,3
dmitry sosnovskiy,1,0,0,0,1
dokonjonosuke mishima,0,2,0,0,2
domingo pilarte,0,2,0,1,3
dominic waters,0,3,0,0,3
dominick cruz,7,3,0,0,10
dominick reyes,8,4,0,0,12
dominique steele,1,4,0,0,5
don frye,9,1,0,0,10
don madge,2,0,0,0,2
don shainis,0,2,0,0,2
don'tale mayes,4,6,0,0,10
donald cerrone,23,14,0,1,38
dong hyun kim,13,4,0,1,18
dong hyun ma,3,5,0,0,8
donghun choi,1,0,0,0,1
dongi yang,2,3,0,0,5
donnie chappell,0,1,0,0,1
donny walker,0,2,0,0,2
dooho choi,5,3,1,0,9
dorian price,0,1,0,0,1
doug evans,0,2,0,0,2
douglas silva de andrade,7,6,0,0,13
drakkar klose,9,3,0,0,12
drako rodriguez,0,2,0,0,2
drew dober,13,10,0,1,24
drew fickett,4,3,0,0,7
drew mcfedries,4,5,0,0,9
dricus du plessis,8,0,0,0,8
duane ludwig,4,5,0,0,9
duda santana,0,1,0,0,1
dusko todorovic,3,5,0,0,8
dustin hazelett,5,5,0,0,10
dustin jacoby,8,6,1,0,15
dustin kimura,2,3,0,0,5
dustin neace,0,1,0,0,1
dustin ortiz,8,6,0,0,14
dustin pague,1,5,0,0,6
dustin poirier,22,8,0,1,31
dustin stoltzfus,3,5,0,0,8
dwayne cason,1,1,0,0,2
dwight grant,3,5,0,0,8
dylan andrews,2,3,0,0,5
dylan budka,0,2,0,0,2
ebenezer fontes braga,1,0,0,0,1
ed herman,13,12,0,1,26
eddie alvarez,4,3,0,1,8
eddie gordon,1,3,0,0,4
eddie mendez,0,1,0,0,1
eddie ruiz,0,1,0,0,1
eddie sanchez,3,3,0,0,6
eddie wineland,6,10,0,0,16
eddie yagin,1,1,0,0,2
edgar chairez,1,2,0,1,4
edgar garcia,0,4,0,0,4
edilberto de oliveira,0,2,0,0,2
edimilson souza,3,1,0,0,4
edmen shahbazyan,6,5,0,0,11
ednaldo oliveira,0,2,0,0,2
edson barboza,18,12,0,0,30
eduarda moura,2,1,0,0,3
eduardo garagorri,1,2,0,0,3
edward faaloloto,0,2,0,0,2
edwin dewees,0,3,0,0,3
edwin figueroa,2,4,0,0,6
efrain escudero,5,7,0,0,12
eiji mitsuoka,0,2,0,0,2
eldo xavier dias,0,1,0,0,1
elias garcia,0,2,0,0,2
elias silverio,3,2,0,0,5
elias theodorou,8,3,0,0,11
eliot marshall,3,3,0,0,6
elise reed,4,4,0,0,8
elizabeth phillips,1,3,0,0,4
elizeu zaleski dos santos,11,4,1,0,16
elves brener,3,2,0,0,5
elvis mutapcic,0,2,1,0,3
elvis sinosic,1,6,0,0,7
emil meek,1,3,0,0,4
emily ducote,2,3,0,0,5
emily kagan,0,2,0,0,2
emily whitmire,2,4,0,0,6
emmanuel yarborough,0,1,0,0,1
enrique barzola,6,3,1,0,10
enrique marin,0,2,0,0,2
enson inoue,1,0,0,0,1
eric martin,0,1,0,0,1
eric schafer,3,6,0,0,9
eric shelton,2,4,0,0,6
eric spicely,2,5,0,0,7
eric wisely,0,2,0,0,2
erick gonzalez,0,3,0,0,3
erick montano,1,2,0,0,3
erick silva,7,8,0,0,15
ericka almeida,0,2,0,0,2
erik koch,5,5,0,0,10
erik perez,7,2,0,0,9
erik silva,0,2,0,0,2
erin blanchfield,6,1,0,0,7
ernest chavez,1,2,0,0,3
ernesta kareckaite,0,1,0,0,1
ernie verdicia,0,1,0,0,1
eryk anders,9,8,0,1,18
esteban ribovics,3,1,0,0,4
estevan payan,0,3,0,0,3
eugene jackson,3,4,0,0,7
eugenio tadeu,0,1,0,0,1
evan dunham,11,9,1,0,21
evan elder,2,2,0,0,4
evan tanner,11,6,0,0,17
fabiano iha,3,4,0,0,7
fabiano scherner,0,2,0,0,2
fabio cherant,0,3,0,0,3
fabio gurgel,0,1,0,0,1
fabio maldonado,5,6,0,0,11
fabricio camoes,1,4,1,0,6
fabricio werdum,12,6,0,0,18
falaniko vitale,1,1,0,0,2
fares ziam,6,2,0,0,8
farid basharat,3,0,0,0,3
fatima kline,0,1,0,0,1
felice herrig,5,5,0,0,10
felicia spencer,3,3,0,0,6
felipe arantes,5,6,1,0,12
felipe bunes,0,1,0,0,1
felipe colares,2,4,0,0,6
felipe dos santos,1,2,0,0,3
felipe lima,2,0,0,0,2
felipe olivieri,0,1,0,0,1
felipe silva,1,2,0,0,3
felix lee mitchell,0,3,0,0,3
feng xiaocan,0,1,0,0,1
fernando bruno,0,2,0,0,2
fernando padilla,2,2,0,0,4
fernie garcia,0,3,0,0,3
filip pejic,0,1,0,0,1
flavio luiz moura,0,1,0,0,1
floyd sword,0,1,0,0,1
forrest griffin,10,5,0,0,15
forrest petz,2,5,0,0,7
francesco maturi,0,1,0,0,1
francimar barroso,4,4,0,1,9
francis carmont,6,3,0,0,9
francis marshall,2,2,0,0,4
francis ngannou,12,2,0,0,14
francisco figueiredo,2,2,0,0,4
francisco prado,1,2,0,0,3
francisco rivera,4,6,0,1,11
francisco trevino,1,2,0,0,3
francisco trinaldo,18,8,0,0,26
frank camacho,2,6,0,0,8
frank caracci,0,1,0,0,1
frank hamaker,1,0,0,0,1
frank lester,0,1,0,0,1
frank mir,16,11,0,0,27
frank shamrock,5,0,0,0,5
frank trigg,2,5,0,0,7
frankie edgar,18,11,1,0,30
frankie perez,1,3,0,0,4
frankie saenz,5,5,0,0,10
fred ettish,0,1,0,0,1
fredson paixao,0,1,0,0,1
fredy serrano,2,2,0,0,4
gabe green,2,3,0,0,5
gabe ruediger,0,3,0,0,3
gabriel benitez,7,8,0,0,15
gabriel bonfim,3,1,0,0,4
gabriel gonzaga,12,10,0,0,22
gabriel miranda,1,2,0,0,3
gabriel santos,1,2,0,0,3
gabriel silva,0,2,0,0,2
gabriella fernandes,2,2,0,0,4
gadzhi omargadzhiev,0,2,0,0,2
gadzhimurad antigulov,2,4,0,0,6
gaetano pirrello,0,2,0,0,2
galore bofando,1,1,0,0,2
gan mcgee,2,2,0,0,4
garett whiteley,0,3,0,0,3
garreth mclellan,1,4,0,0,5
garrett armfield,1,3,0,0,4
gary goodridge,4,4,0,0,8
gasan umalatov,1,3,0,0,4
gaston bolanos,2,1,0,0,3
gavin tucker,4,3,0,0,7
geane herrera,1,3,0,0,4
gegard mousasi,9,3,0,0,12
genaro valdez,0,3,0,0,3
genki sudo,2,1,0,0,3
geoff neal,7,4,0,0,11
george roop,5,8,0,0,13
george sotiropoulos,7,4,0,0,11
george sullivan,3,4,0,0,7
georges st-pierre,20,2,0,0,22
gerald harris,3,1,0,0,4
gerald meerschaert,12,10,0,0,22
gerald strebendt,0,1,0,0,1
geraldo de freitas,1,2,0,0,3
germaine de randamie,7,3,0,0,10
gerry harris,0,1,0,0,1
geza kalman,1,1,0,0,2
gian villante,7,11,0,0,18
gideon ray,0,3,0,0,3
giga chikadze,7,2,0,0,9
gil castillo,1,2,0,0,3
gilbert aldana,0,2,0,0,2
gilbert burns,15,8,0,0,23
gilbert melendez,1,6,0,0,7
gilbert smith,0,1,0,0,1
gilbert urbina,1,2,0,0,3
gilbert yvel,0,3,0,0,3
gillian robertson,12,6,0,0,18
gina mazany,2,6,0,0,8
glaico franca moreira,1,2,0,0,3
gleison tibau,16,12,0,0,28
gloria de paula,1,3,0,0,4
glover teixeira,16,7,0,0,23
godofredo pepey,5,6,0,0,11
gokhan saki,1,1,0,0,2
goran reljic,1,3,0,0,4
grant dawson,10,1,1,0,12
gray maynard,11,7,1,1,20
greg hardy,4,5,0,1,10
greg soto,1,2,0,0,3
greg stott,0,1,0,0,1
gregor gillespie,7,1,0,0,8
gregory rodrigues,7,2,0,0,9
grigory popov,0,2,0,0,2
guangyou ning,2,2,0,0,4
guido cannetti,4,6,0,0,10
guilherme vasconcelos,0,1,0,0,1
gunnar nelson,10,5,0,0,15
guram kutateladze,2,2,0,0,4
gustavo lopez,1,2,1,0,4
guto inocente,0,2,0,0,2
guy mezger,4,1,0,0,5
hacran dias,3,5,0,0,8
hailey cowan,0,1,0,0,1
hakeem dawodu,6,4,0,0,10
hamdy abdelwahab,1,0,0,0,1
hannah cifers,2,5,0,0,7
hannah goldy,1,4,0,0,5
hans stringer,1,2,0,0,3
harold howard,1,2,0,0,3
harry hunsucker,0,3,0,0,3
harry moskowitz,0,2,0,0,2
hatsu hioki,3,5,0,0,8
hayato sakurai,0,1,0,0,1
hayder hassan,0,2,0,0,2
he-man gipson,0,1,0,0,1
heath herring,2,3,0,0,5
heather clark,1,2,0,0,3
hector aldana,0,3,0,0,3
hector lombard,3,8,0,1,12
hector ramirez,0,2,0,0,2
hector sandoval,2,2,0,0,4
hector urbina,1,2,0,0,3
henrique da silva,2,4,0,0,6
henry briones,1,4,0,0,5
henry cejudo,10,4,0,0,14
henry martinez,1,2,0,0,3
herbert burns,2,4,0,0,6
hermes franca,6,5,0,0,11
hernani perpetuo,0,2,0,0,2
holly holm,8,8,0,0,16
homer moore,0,1,0,0,1
horacio gutierrez,0,2,0,0,2
houston alexander,2,4,0,0,6
houston dorr,0,1,0,0,1
hu yaozong,0,3,0,0,3
hugo duarte,0,1,0,0,1
hugo viana,3,3,0,0,6
humberto bandenay,1,3,0,0,4
humberto brown morrison,0,1,0,0,1
hunter azure,2,2,0,0,4
hyder amil,2,0,0,0,2
hyun gyu lim,3,4,0,0,7
hyunsung park,2,0,0,0,2
ian entwistle,1,2,0,0,3
ian freeman,3,2,1,0,6
ian garry,6,0,0,0,6
ian heinisch,3,4,0,0,7
ian loveland,1,2,0,0,3
ian machado garry,2,1,0,0,3
ian mccall,2,3,1,0,6
iasmin lucindo,4,1,0,0,5
ibo aslan,1,0,0,0,1
icho larenas,0,1,0,0,1
ignacio bahamondes,5,2,0,0,7
igor araujo,2,2,0,0,4
igor pokrajac,4,8,0,1,13
igor severino,0,1,0,0,1
igor zinoviev,0,1,0,0,1
ihor potieria,2,5,0,0,7
ike villanueva,1,5,0,0,6
ikram aliskerov,1,1,0,0,2
ikuhisa minowa,1,0,0,0,1
ildemar alcantara,4,3,0,0,7
ilia topuria,7,0,0,0,7
iliarde santos,0,3,0,0,3
ilir latifi,9,7,0,0,16
impa kasanganay,2,2,0,0,4
inoue mizuki,1,1,0,0,2
ion cutelaba,7,9,1,0,17
irene aldana,8,6,0,0,14
irina alekseeva,1,1,0,0,2
irwin rivera,1,2,0,0,3
isaac dulgarian,2,1,0,0,3
isaac vallie-flagg,1,3,0,0,4
isabela de padua,0,1,0,0,1
islam makhachev,14,1,0,0,15
ismael bonfim,2,1,0,0,3
ismail naurdiev,2,2,0,0,4
israel adesanya,13,4,0,0,17
issei tamura,1,2,0,0,3
istela nunes,0,4,0,0,4
iuri alcantara,10,7,0,1,18
ivan erslan,0,1,0,0,1
ivan jorge,2,2,0,0,4
ivan menjivar,4,5,0,0,9
ivan salaverry,3,4,0,0,7
ivan serati,0,1,0,0,1
ivana petrovic,1,2,0,0,3
izabela badurek,0,1,0,0,1
jacare souza,9,7,0,0,16
jack della maddalena,7,0,0,0,7
jack hermansson,11,6,0,0,17
jack jenkins,3,1,0,0,4
jack marshman,3,5,0,0,8
jack may,0,2,0,0,2
jack mcglaughlin,0,1,0,0,1
jack nilson,1,1,0,0,2
jack shore,6,3,0,0,9
jackie lee,0,1,0,0,1
jacob kilburn,0,2,0,0,2
jacob malkoun,4,3,0,0,7
jacob volkmann,6,4,0,0,10
jacqueline cavalcanti,3,0,0,0,3
jafel filho,2,1,0,0,3
jai herbert,3,4,1,0,8
jailton almeida,7,1,0,0,8
jairzinho rozenstruik,9,5,0,0,14
jake collier,5,9,0,0,14
jake ellenberger,10,11,0,0,21
jake hadley,3,4,0,0,7
jake hecht,1,2,0,0,3
jake lindsey,0,3,0,0,3
jake matthews,13,7,0,0,20
jake o'brien,4,3,0,0,7
jake rosholt,1,2,0,0,3
jake shields,4,3,0,1,8
jalin turner,7,5,0,0,12
jamahal hill,6,2,0,1,9
jamal pogues,2,1,0,0,3
jamall emmers,3,4,0,0,7
james bochnovic,0,2,0,0,2
james giboo,0,1,0,0,1
james hammortree,0,1,0,0,1
james head,2,3,0,0,5
james irvin,4,6,0,0,10
james krause,9,4,0,0,13
james lee,0,1,0,0,1
james llontop,0,3,0,0,3
james mcsweeney,1,2,0,0,3
james moontasri,2,4,0,0,6
james mulheron,0,1,0,0,1
james te huna,5,5,0,0,10
james toney,0,1,0,0,1
james vick,9,5,0,0,14
james wilks,2,2,0,0,4
james zikic,0,1,0,0,1
jamey simmons,0,2,0,0,2
jamey-lyn horth,2,2,0,0,4
jamie moyle,1,2,0,0,3
jamie mullarkey,5,6,0,0,11
jamie pickett,2,7,0,0,9
jamie varner,3,6,0,0,9
jamie yager,0,1,0,0,1
jan blachowicz,12,7,1,0,20
jaqueline amorim,3,1,0,0,4
jared cannonier,10,8,0,0,18
jared gooden,2,5,0,0,7
jared gordon,8,6,0,1,15
jared hamman,2,5,0,0,7
jared papazian,0,3,0,0,3
jared rollins,0,1,0,0,1
jared rosholt,6,2,0,0,8
jared vanderaa,1,6,0,0,7
jarjis danho,1,1,1,0,3
jarno errens,1,2,0,0,3
jarred brooks,2,2,0,0,4
jasmine jasudavicius,6,2,0,0,8
jason black,0,2,0,0,2
jason brilz,3,4,0,0,7
jason day,1,2,0,0,3
jason delucia,1,2,0,0,3
jason dent,1,3,0,0,4
jason fairn,0,1,0,0,1
jason gilliam,0,2,0,0,2
jason godsey,0,2,0,0,2
jason gonzalez,1,3,0,0,4
jason high,2,3,0,0,5
jason knight,4,5,0,0,9
jason lambert,4,4,0,0,8
jason macdonald,6,8,0,0,14
jason miller,0,3,0,0,3
jason novelli,0,2,0,0,2
jason reinhardt,0,3,0,0,3
jason saggo,3,3,0,0,6
jason tan,0,2,0,0,2
jason thacker,0,1,0,0,1
jason von flue,1,2,0,0,3
jason witt,2,4,0,0,6
jason young,1,3,0,0,4
javid basharat,3,1,0,0,4
javier vazquez,1,0,0,0,1
jay cucciniello,0,1,0,0,1
jay hieron,0,4,0,0,4
jay perrin,0,3,0,0,3
jay silva,0,2,0,0,2
jc cottrell,0,2,0,0,2
jean matsumoto,2,0,0,0,2
jean silva,3,0,0,0,3
jeff cox,0,2,0,0,2
jeff curran,0,3,0,0,3
jeff hougland,1,2,0,0,3
jeff hughes,0,3,0,1,4
jeff joslin,0,1,0,0,1
jeff molina,3,0,0,0,3
jeff monson,4,3,0,0,7
jeff newton,0,1,0,0,1
jeka saragih,1,2,0,0,3
jenel lausa,1,3,0,0,4
jennifer maia,6,6,0,0,12
jens pulver,6,2,1,0,9
jeongyeong lee,2,1,0,0,3
jeremiah wells,4,2,0,0,6
jeremy horn,6,7,0,0,13
jeremy jackson,0,2,0,0,2
jeremy kennedy,3,1,0,0,4
jeremy kimball,1,3,0,0,4
jeremy larsen,0,3,0,0,3
jeremy stephens,15,18,0,1,34
jermaine andre,0,1,0,0,1
jerome rivera,0,4,0,0,4
jerrod sanders,1,2,0,1,4
jerry bohlander,5,2,0,0,7
jess liaudin,2,3,0,0,5
jessamyn duke,1,3,0,0,4
jesse bongfeldt,0,1,1,0,2
jesse butler,0,2,0,0,2
jesse forbes,0,3,0,0,3
jesse lennox,1,2,0,0,3
jesse ronson,0,5,0,1,6
jesse sanders,0,1,0,0,1
jesse strader,0,2,0,0,2
jesse taylor,1,1,0,0,2
jessica aguilar,1,4,0,0,5
jessica andrade,17,11,0,0,28
jessica eye,5,10,0,1,16
jessica penne,3,6,0,0,9
jessica rakoczy,0,2,0,0,2
jessica-rose clark,4,5,0,0,9
jessin ayari,1,3,0,0,4
jesus aguilar,3,1,0,0,4
jesus pinedo,1,1,0,0,2
jhonata diniz,2,1,0,0,3
ji yeon kim,3,7,0,0,10
jianping yang,0,1,0,0,1
jim alers,1,2,0,1,4
jim miller,27,17,0,1,45
jim mullen,0,1,0,0,1
jim wallhead,0,2,0,0,2
jimi manuwa,6,6,0,0,12
jimmie rivera,7,4,0,0,11
jimmy crute,4,4,1,0,9
jimmy flick,2,3,0,0,5
jimmy quinlan,0,1,0,0,1
jimy hettes,3,3,0,0,6
jin soo son,0,2,0,0,2
jinh yu frey,2,5,0,0,7
jiri prochazka,4,2,0,0,6
jj aldrich,8,6,0,0,14
joachim christensen,1,3,0,0,4
joanderson brito,5,2,0,0,7
joanna jedrzejczyk,10,5,0,0,15
joanne wood,9,8,0,0,17
joao pierini,0,1,0,0,1
joao roque,0,1,0,0,1
joao zeferino,0,2,0,0,2
joaquim silva,6,5,0,0,11
joaquin buckley,11,4,0,0,15
joby sanchez,1,4,0,0,5
jocelyn jones-lybarger,0,3,0,0,3
jodie esquibel,0,4,0,0,4
joe brammer,0,2,0,0,2
joe charles,2,2,0,0,4
joe doerksen,2,7,0,0,9
joe duffy,4,4,0,0,8
joe ellenberger,1,1,0,0,2
joe giannetti,0,1,0,0,1
joe jordan,0,1,0,0,1
joe lauzon,15,12,0,0,27
joe merritt,0,1,0,0,1
joe moreira,1,1,0,0,2
joe pardo,0,1,0,0,1
joe proctor,4,4,0,0,8
joe pyfer,4,1,0,0,5
joe riggs,5,7,0,0,12
joe slick,1,1,0,0,2
joe solecki,5,3,0,0,8
joe son,0,1,0,0,1
joe soto,3,5,0,0,8
joe stevenson,8,8,0,0,16
joe vedepo,0,2,0,0,2
joe veres,0,2,0,0,2
joel alvarez,7,2,0,0,9
joel sutton,2,0,0,0,2
joey beltran,3,6,0,1,10
joey gambino,0,2,0,0,2
joey gilbert,0,1,0,0,1
joey gomez,0,2,0,0,2
joey roberts,0,1,0,0,1
john albert,1,4,0,0,5
john alessio,0,5,0,0,5
john allan,0,2,0,1,3
john campetella,0,1,0,0,1
john castaneda,4,3,0,0,7
john cholish,1,2,0,0,3
john cofer,0,2,0,0,2
john dodson,10,7,0,0,17
john dowdy,0,1,0,0,1
john gunderson,1,2,0,0,3
john gunther,1,1,0,0,2
john halverson,0,2,0,0,2
john hathaway,7,2,0,0,9
john howard,7,7,0,0,14
john kolosci,0,1,0,0,1
john lewis,1,1,0,0,2
john lineker,12,4,0,0,16
john lober,0,1,0,0,1
john maguire,2,3,0,0,5
john makdessi,11,9,0,0,20
john marsh,0,1,0,0,1
john matua,0,1,0,0,1
john moraga,8,6,0,0,14
john phillips,1,5,0,0,6
john polakowski,0,1,0,0,1
john salter,1,2,0,0,3
john teixeira,0,1,0,0,1
johnny bedford,2,3,0,1,6
johnny case,4,2,0,0,6
johnny eduardo,3,5,0,0,8
johnny munoz,2,4,0,0,6
johnny rees,0,2,0,0,2
johnny rhodes,2,1,0,0,3
johnny walker,7,6,0,0,13
johny hendricks,13,8,0,0,21
jon delos reyes,1,3,0,0,4
jon fitch,14,3,1,0,18
jon hess,1,0,0,0,1
jon jones,22,1,0,1,24
jon madsen,4,1,0,0,5
jon manley,0,1,0,0,1
jon olav einemo,0,2,0,0,2
jon tuck,4,5,0,0,9
jonathan brookins,2,3,0,0,5
jonathan goulet,4,5,0,0,9
jonathan martinez,10,5,0,0,15
jonathan meunier,1,1,0,0,2
jonathan pearce,5,4,0,0,9
jonathan wiezorek,1,0,0,0,1
jonathan wilson,1,3,0,0,4
jonavin webb,0,2,0,0,2
jonny parsons,1,0,0,0,1
jordan espinosa,2,4,0,0,6
jordan griffin,1,4,0,0,5
jordan johnson,4,0,0,0,4
jordan leavitt,4,3,0,0,7
jordan mein,5,4,0,0,9
jordan radev,0,2,0,0,2
jordan rinaldi,2,3,0,0,5
jordan vucenic,0,1,0,0,1
jordan williams,0,3,0,0,3
jordan wright,2,5,0,0,7
jorge de oliveira,0,2,0,0,2
jorge gurgel,3,4,0,0,7
jorge lopez,0,2,0,0,2
jorge masvidal,12,10,0,0,22
jorge patino,0,1,0,0,1
jorge rivera,8,7,0,0,15
jorge santiago,1,5,0,0,6
jose aldo,14,8,0,0,22
jose daniel medina,0,1,0,0,1
jose johnson,1,2,0,0,3
jose maria,0,2,0,0,2
jose ochoa,0,1,0,0,1
jose quinonez,5,4,0,0,9
jose torres,1,1,0,0,2
josefine knutsson,2,1,0,0,3
joselyne edwards,5,4,0,0,9
joseph benavidez,15,6,0,0,21
joseph gigliotti,0,2,0,0,2
joseph holmes,1,3,0,0,4
joseph morales,1,2,0,0,3
joseph sandoval,0,2,0,0,2
josh barnett,7,3,0,0,10
josh bryant,0,1,0,0,1
josh clopton,0,2,0,0,2
josh copeland,0,2,0,0,2
josh culibao,3,4,1,0,8
josh emmett,10,4,0,0,14
josh ferguson,0,2,0,0,2
josh fremd,2,4,0,0,6
josh grispi,0,4,0,0,4
josh haynes,0,3,0,0,3
josh hendricks,0,1,0,0,1
josh koscheck,15,10,0,0,25
josh neer,6,9,0,0,15
josh parisian,2,5,0,0,7
josh quinlan,1,3,0,0,4
josh rafferty,0,1,0,0,1
josh samman,3,2,0,0,5
josh sampo,1,3,0,0,4
josh shockley,0,2,0,0,2
josh shockman,0,1,0,0,1
josh stansbury,1,2,0,0,3
josh stuart,0,1,0,0,1
josh thomson,3,4,0,0,7
joshua burkman,6,12,0,1,19
joshua van,5,1,0,0,6
joshua weems,0,1,0,0,1
josiane nunes,3,2,0,0,5
journey newson,1,4,0,1,6
jp buys,0,4,0,0,4
juan adams,1,3,0,0,4
juan espino,2,1,0,0,3
juan manuel puig,0,2,0,0,2
juancamilo ronderos,0,2,0,0,2
jules bruchez,0,1,0,0,1
julia avila,3,2,0,0,5
julia polastri,1,1,0,0,2
julian erosa,8,7,0,0,15
julian marquez,3,4,0,0,7
julian sanchez,0,1,0,0,1
juliana lima,3,4,0,0,7
juliana miller,1,2,0,0,3
julianna pena,8,3,0,0,11
julie kedzie,0,2,0,0,2
julija stoliarenko,2,6,0,0,8
julio arce,6,4,0,0,10
julio paulino,0,2,0,0,2
jumabieke tuerxun,0,3,0,0,3
junie browning,1,1,0,0,2
junior albini,1,4,0,0,5
junior assuncao,2,3,0,0,5
junior dos santos,15,8,0,0,23
junior tafa,1,3,0,0,4
junyong park,8,3,0,0,11
jussier formiga,9,7,0,0,16
justin buchholz,1,4,0,0,5
justin edwards,2,5,0,0,7
justin eilers,1,3,0,0,4
justin frazier,0,1,0,0,1
justin gaethje,8,5,0,0,13
justin james,0,1,0,0,1
justin jaynes,1,4,0,0,5
justin jones,0,2,0,0,2
justin lawrence,1,2,0,0,3
justin ledet,3,4,0,0,7
justin levens,0,2,0,0,2
justin martin,1,0,0,0,1
justin mccully,2,2,0,0,4
justin salas,3,4,0,0,7
justin scoggins,4,5,0,0,9
justin tafa,4,4,0,1,9
justin willis,4,1,0,0,5
justin wren,0,1,0,0,1
justine kish,3,4,0,0,7
jutaro nakao,1,1,0,0,2
kaan ofli,0,1,0,0,1
kai asakura,0,1,0,0,1
kai kamaka,1,2,1,0,4
kai kara-france,8,4,0,0,12
kailin curran,1,6,0,0,7
kajan johnson,4,3,0,0,7
kalib starnes,2,3,0,0,5
kalindra faria,0,3,0,0,3
kamal shalorus,0,3,0,0,3
kamaru usman,15,2,0,0,17
kamuela kirk,1,2,0,0,3
kanako murata,1,2,0,0,3
karine gevorgyan,0,1,0,0,1
karine silva,4,1,0,0,5
karl roberson,4,6,0,0,10
karl williams,3,1,0,0,4
karlos vemola,2,4,0,0,6
karo parisyan,8,4,0,1,13
karol rosa,7,3,0,0,10
karolina kowalkiewicz,9,9,0,0,18
katlyn cerminara,0,1,0,0,1
katlyn chookagian,11,5,0,0,16
katsuhisa fujii,1,1,0,0,2
katsunori kikuno,2,3,0,0,5
kaue fernandes,1,1,0,0,2
kay hansen,1,3,0,0,4
kayla harrison,2,0,0,0,2
kaynan kruschewsky,0,2,0,0,2
kazuhiro nakamura,0,2,0,0,2
kazuki tokudome,1,3,0,0,4
kazula vargas,1,3,0,0,4
kazushi sakuraba,1,0,0,1,2
kb bhullar,0,2,0,0,2
keigo kunihara,0,1,0,0,1
keiichiro yamamiya,0,1,0,0,1
keita nakamura,4,7,0,0,11
keith berish,0,1,0,1,2
keith hackney,2,2,0,0,4
keith jardine,6,7,0,0,13
keith mielke,0,1,0,0,1
keith rockel,1,1,0,0,2
keith wisniewski,0,4,0,0,4
kelly dullanty,0,1,0,0,1
kelly faszholz,0,2,0,0,2
kelvin gastelum,13,9,0,1,23
ken shamrock,4,4,0,0,8
ken stone,2,2,0,0,4
kendall grove,7,6,0,0,13
kenichi yamamoto,2,1,0,0,3
kennedy nzechukwu,7,5,0,0,12
kenny florian,12,5,0,0,17
kenny robertson,4,5,0,0,9
kerry schall,0,1,0,0,1
ketlen souza,2,1,0,0,3
ketlen vieira,8,4,0,0,12
kevin aguilar,2,4,0,0,6
kevin borjas,0,2,0,0,2
kevin burns,2,3,0,0,5
kevin casey,1,3,1,2,7
kevin croom,0,3,0,1,4
kevin ferguson,1,1,0,0,2
kevin holland,13,9,0,1,23
kevin jackson,2,2,0,0,4
kevin jordan,0,2,0,0,2
kevin jousset,2,1,0,0,3
kevin lee,11,8,0,0,19
kevin natividad,0,3,0,0,3
kevin randleman,4,3,0,0,7
kevin rosier,0,1,0,0,1
khabib nurmagomedov,13,0,0,0,13
khadis ibragimov,0,4,0,0,4
khalid murtazaliev,1,0,0,0,1
khalid taha,1,4,0,1,6
khalil rountree jr.,9,6,0,1,16
khama worthy,2,3,0,0,5
khamzat chimaev,6,0,0,0,6
khaos williams,6,2,0,0,8
khusein askhabov,0,1,0,0,1
kiefer crosbie,0,2,0,0,2
kiichi kunimoto,3,2,0,0,5
kimo leopoldo,2,3,0,0,5
king green,0,1,0,0,1
kiru sahota,0,1,0,0,1
kit cope,0,1,0,0,1
kj noons,2,3,0,1,6
klaudia sygula,0,1,0,0,1
kleydson rodrigues,1,3,0,0,4
klidson abreu,1,2,0,1,4
koji kitao,0,1,0,0,1
koji oishi,0,2,0,0,2
konstantin erokhin,0,2,0,0,2
kris mccray,0,3,0,0,3
kris moutinho,0,2,0,0,2
kristian rothaermel,0,1,0,0,1
kristof midoux,0,1,0,0,1
kron gracie,1,3,0,0,4
krzysztof jotko,11,6,0,0,17
krzysztof soszynski,6,3,0,0,9
kuniyoshi hironaka,1,3,0,0,4
kurt holobaugh,2,5,0,0,7
kurt pellegrino,7,5,0,0,12
kwan ho kwak,0,2,0,0,2
kyle bochniak,2,5,0,0,7
kyle bradley,1,3,0,0,4
kyle daukaus,2,4,0,1,7
kyle kingsbury,4,5,0,0,9
kyle nelson,4,5,1,0,10
kyle noke,6,6,0,0,12
kyle prepolec,0,2,0,0,2
kyle stewart,0,2,0,0,2
kyle watson,1,1,0,0,2
kyler phillips,6,2,0,0,8
kyoji horiguchi,7,1,0,0,8
kyung ho kang,8,5,0,1,14
lance benoist,2,2,0,0,4
lance gibson,1,1,0,0,2
lando vannata,4,7,2,0,13
landon quinones,0,2,0,0,2
lara procopio,1,2,0,0,3
larissa pacheco,0,2,0,0,2
larry cureton,0,2,0,0,2
laureano staropoli,2,4,0,0,6
lauren mueller,1,3,0,0,4
lauren murphy,8,6,0,0,14
lavar johnson,2,2,0,0,4
laverne clark,4,1,0,0,5
leah letson,1,1,0,0,2
leandro issa,2,3,0,0,5
leandro silva,3,4,0,1,8
lee murray,1,0,0,0,1
leigh remedios,0,1,0,0,1
leo kuntz,0,2,0,0,2
leon edwards,14,3,0,1,18
leonard garcia,2,7,0,0,9
leonardo guimaraes,0,2,0,0,2
leonardo mafra,1,3,0,0,4
leonardo morales,0,2,0,0,2
leonardo santos,7,3,1,0,11
lerone murphy,6,0,1,0,7
leslie smith,4,3,0,0,7
levan makashvili,1,1,1,0,3
lewis gonzalez,0,1,0,0,1
li jingliang,11,7,0,0,18
liana jojua,1,3,0,0,4
liang na,0,2,0,0,2
liliya shakirova,0,1,0,0,1
lina lansberg,4,7,0,0,11
lisa ellis,0,2,0,0,2
liudvik sholinian,0,2,0,0,2
livinha souza,3,3,0,0,6
liz carmouche,5,5,0,0,10
lodune sincaid,0,1,0,0,1
logan clark,1,0,0,0,1
loik radzhabov,2,2,0,0,4
loma lookboonmee,6,2,0,0,8
lone'er kavanagh,1,0,0,0,1
loopy godinez,7,5,0,0,12
lorenz larkin,5,5,0,0,10
louis cosce,0,2,0,0,2
louis gaudinot,1,3,0,1,5
louis smolka,8,9,0,0,17
lowell anderson,0,1,0,0,1
luan chagas,1,2,1,0,4
luan lacerda,0,2,0,0,2
luana carolina,6,3,0,0,9
luana pinheiro,3,3,0,0,6
luana santos,3,1,0,0,4
lucas alexander,1,2,0,0,3
lucas almeida,2,2,0,0,4
lucas martins,4,3,0,0,7
lucas rocha,0,1,0,0,1
lucie pudilova,3,8,0,0,11
lucio linhares,0,2,0,0,2
ludovit klein,7,2,1,0,10
luigi fioravanti,4,5,0,0,9
luigi vendramini,1,3,0,0,4
luis henrique,2,4,0,0,6
luis pajuelo,0,1,0,0,1
luis pena,5,3,0,0,8
luis ramos,0,2,0,0,2
luis saldana,2,1,1,0,4
luiz cane,4,5,0,0,9
luiz dutra,0,2,0,0,2
lukasz brzeski,1,4,0,0,5
lukasz sajewski,0,3,0,0,3
luke barnatt,3,3,0,0,6
luke caudillo,0,2,0,0,2
luke cummo,3,4,0,0,7
luke jumeau,2,2,0,0,4
luke rockhold,6,5,0,0,11
luke sanders,3,5,0,0,8
luke zachrich,1,2,0,0,3
lyman good,3,3,0,0,6
lyoto machida,16,8,0,0,24
mac danzig,5,8,0,0,13
maciej jewtuszko,0,1,0,0,1
mackens semerzier,1,1,0,1,3
mackenzie dern,9,5,0,0,14
macy chiasson,8,3,0,0,11
mads burnell,1,2,0,0,3
magnus cedenblad,4,2,0,0,6
magomed ankalaev,10,1,1,0,12
magomed gadzhiyasulov,1,0,0,0,1
magomed mustafaev,3,2,0,0,5
maheshate,2,3,0,0,5
maia stevenson,0,1,0,0,1
maiquel falcao,1,0,0,0,1
mairbek taisumov,7,2,0,0,9
mairon santos,1,0,0,0,1
makhmud muradov,4,2,0,1,7
maki pitolo,1,5,0,0,6
makwan amirkhani,7,7,0,0,14
malcolm gordon,2,5,0,0,7
mallory martin,1,3,0,0,4
mana martinez,2,2,0,0,4
mandy bohm,1,2,0,0,3
manel kape,5,3,0,0,8
manny bermudez,3,2,0,0,5
manolo zecchini,0,1,0,0,1
manon fiorot,7,0,0,0,7
mansur abdul-malik,1,0,0,0,1
manuel rodriguez,0,1,0,0,1
manuel torres,3,1,0,0,4
manvel gamburyan,6,8,0,1,15
mara romero borella,2,5,0,0,7
marc diakiese,8,7,0,0,15
marc-andre barriault,5,8,0,1,14
marcel fortuna,1,2,0,0,3
marcelo aguiar,0,1,0,0,1
marcelo golm,1,3,0,0,4
marcelo guimaraes,2,2,0,0,4
marcelo mello,1,0,0,0,1
marcelo rojo,0,3,0,0,3
marcin bandel,0,2,0,0,2
marcin held,1,3,0,0,4
marcin prachnio,4,6,0,0,10
marcin tybura,13,8,0,0,21
marcin wrzosek,0,1,0,0,1
marcio alexandre junior,0,3,0,0,3
marcio cruz,2,2,0,0,4
marco beltran,3,3,0,0,6
marco polo reyes,4,4,0,0,8
marco ruas,4,2,0,0,6
marcos mariano,0,2,0,0,2
marcos rogerio de lima,11,7,0,0,18
marcos vinicius,1,2,0,0,3
marcus aurelio,2,4,0,0,6
marcus bossett,1,2,0,0,3
marcus brimage,4,4,0,0,8
marcus davis,9,6,0,0,15
marcus jones,0,1,0,0,1
marcus levesseur,1,2,0,0,3
marcus mcghee,4,0,0,0,4
marcus silveira,0,1,0,1,2
maria oliveira,1,3,0,0,4
marina rodriguez,7,5,2,0,14
mario bautista,9,2,0,0,11
mario miranda,1,3,0,0,4
mario neto,0,1,0,0,1
marion reneau,5,7,1,0,13
mariya agapova,2,4,0,0,6
mark bocek,8,5,0,0,13
mark coleman,7,5,0,0,12
mark de la rosa,2,5,0,0,7
mark eddiva,1,3,0,0,4
mark godbeer,2,2,0,0,4
mark hall,4,3,0,0,7
mark holst,0,2,0,0,2
mark hominick,3,4,0,0,7
mark hughes,1,0,0,0,1
mark hunt,8,8,1,1,18
mark kerr,4,0,0,0,4
mark madsen,4,2,0,0,6
mark munoz,9,6,0,0,15
mark robinson,0,0,0,1,1
mark scanlon,0,1,0,0,1
mark schultz,1,0,0,0,1
mark striegl,0,2,0,0,2
mark weir,1,2,0,0,3
markus perez,2,5,0,0,7
marlon moraes,5,6,0,0,11
marlon vera,15,9,0,0,24
marnic mann,0,2,0,0,2
marquel mederos,1,0,0,0,1
martin bravo,1,3,0,0,4
martin buday,5,1,0,0,6
martin day,0,4,0,0,4
martin kampmann,11,6,0,0,17
martin sano,0,1,0,0,1
martin svensson,0,1,0,0,1
marvin eastman,1,4,0,0,5
marvin vettori,9,5,1,0,15
maryna moroz,6,6,0,0,12
masanori kanehara,1,2,0,0,3
masio fullen,1,2,0,0,3
mason jones,1,2,0,1,4
masutatsu yano,0,1,0,0,1
mateus mendonca,0,3,0,0,3
mateusz gamrot,7,3,0,0,10
mateusz rebecki,3,1,0,0,4
matheus nicolau,7,4,0,0,11
mats nilsson,0,2,0,0,2
matt andersen,0,1,0,0,1
matt arroyo,1,2,0,0,3
matt bessette,0,2,0,0,2
matt brown,17,13,0,0,30
matt dwyer,1,3,0,0,4
matt frevola,5,5,1,0,11
matt grice,2,5,0,0,7
matt hamill,10,5,0,0,15
matt hobar,1,2,0,0,3
matt horwich,0,2,0,0,2
matt hughes,18,7,0,0,25
matt lindland,9,3,0,0,12
matt lucas,0,1,0,0,1
matt mitrione,9,5,0,0,14
matt sayles,1,3,0,0,4
matt schnell,6,7,0,1,14
matt serra,7,7,0,0,14
matt van buren,0,2,0,0,2
matt veach,1,2,0,0,3
matt wiman,10,8,0,0,18
matthew lopez,2,4,0,0,6
matthew riddle,7,3,0,2,12
matthew semelsberger,5,6,0,0,11
maurice greene,4,4,0,0,8
maurice smith,4,3,0,0,7
mauricio rua,11,12,1,0,24
mauricio ruffy,2,0,0,0,2
max griffin,8,9,0,0,17
max holloway,21,7,0,0,28
max rohskopf,0,1,0,0,1
maxim grishin,2,3,0,0,5
maximo blanco,4,5,0,0,9
maycee barber,9,2,0,0,11
mayra bueno silva,6,4,1,0,11
megan anderson,3,3,0,0,6
mehdi baghdad,0,2,0,0,2
melinda fabian,0,1,1,0,2
melissa dixon,1,0,0,0,1
melissa gatto,3,2,0,0,5
melissa martinez,1,1,0,0,2
melissa mullins,1,1,0,0,2
melquizael costa,2,2,0,0,4
melsik baghdasaryan,3,1,0,0,4
melton bowen,0,1,0,0,1
melvin guillard,12,9,0,1,22
merab dvalishvili,11,2,0,0,13
michael bisping,20,9,0,0,29
michael chandler,2,4,0,0,6
michael chiesa,13,7,0,0,20
michael graves,2,0,1,0,3
michael johnson,15,15,0,0,30
michael kuiper,1,3,0,0,4
michael mcbride,0,2,0,0,2
michael mcdonald,6,3,0,0,9
michael morales,5,0,0,0,5
michael page,1,1,0,0,2
michael patt,0,2,0,0,2
michael trizano,4,3,0,0,7
michal figlak,0,2,0,0,2
michal oleksiejczuk,6,7,0,1,14
micheal gillmore,0,2,0,0,2
michel batista,0,1,0,0,1
michel pereira,9,3,0,0,12
michel prazeres,10,4,0,0,14
michel quinones,0,2,0,0,2
michelle waterson,6,5,0,0,11
michelle waterson-gomez,0,4,0,0,4
michihiro omigawa,1,6,0,0,7
michinori tanaka,2,3,0,0,5
mick parkin,4,0,0,0,4
mickael lebout,1,2,0,0,3
mickey gall,6,7,0,0,13
miesha tate,7,6,0,0,13
miguel baeza,3,4,0,0,7
miguel torres,2,2,0,0,4
mike breeden,0,3,0,0,3
mike brown,2,4,0,0,6
mike ciesnolevicz,1,1,0,0,2
mike davis,4,1,0,0,5
mike de la torre,2,4,0,1,7
mike easton,3,4,0,0,7
mike grundy,1,3,0,0,4
mike guymon,1,3,0,0,4
mike jackson,1,2,0,1,4
mike king,0,1,0,0,1
mike kyle,2,1,0,0,3
mike lullo,0,2,0,0,2
mike malott,4,1,0,0,5
mike massenzio,2,5,0,0,7
mike nickels,1,1,0,0,2
mike perry,7,8,0,0,15
mike pierce,9,5,0,0,14
mike pyle,10,9,0,0,19
mike rhodes,0,3,0,0,3
mike ricci,1,2,0,0,3
mike rio,1,3,0,0,4
mike rodriguez,2,5,0,1,8
mike russow,4,2,0,0,6
mike santiago,0,3,0,0,3
mike stumpf,0,2,0,0,2
mike swick,10,5,0,0,15
mike van arsdale,2,2,0,0,4
mike wessel,0,1,0,0,1
mike whitehead,0,1,0,0,1
mike wilkinson,2,2,0,0,4
mikey burnett,2,1,0,0,3
milana dudieva,1,2,0,0,3
miles johns,7,3,0,0,10
milton vieira,0,1,1,0,2
minoki ichihara,0,1,0,0,1
miranda granger,1,3,0,0,4
miranda maverick,8,3,0,0,11
mirko filipovic,5,6,0,0,11
mirsad bektic,6,4,0,0,10
misha cirkunov,6,7,0,0,13
mitch clarke,2,5,0,0,7
mitch gagnon,4,4,0,0,8
mitch ramirez,0,1,0,0,1
mitch raposo,0,1,0,0,1
mizuki,1,0,0,0,1
mizuto hirota,1,5,1,0,7
modestas bukauskas,4,4,0,0,8
mohammad yahya,0,1,0,0,1
mohammed usman,3,2,0,0,5
molly mccann,7,6,0,0,13
montana de la rosa,6,5,1,0,12
montel jackson,8,2,0,0,10
montserrat conejo,1,1,0,0,2
montserrat conejo ruiz,0,2,0,0,2
montserrat rendon,1,1,0,0,2
morgan charriere,2,1,0,0,3
mostapha al-turk,0,3,0,0,3
moti horenstein,0,2,0,0,2
motonobu tezuka,0,2,0,0,2
mounir lazzez,2,2,0,0,4
movsar evloev,9,0,0,0,9
muhammad mokaev,6,0,0,0,6
muhammad naimov,2,1,0,0,3
muin gafurov,1,1,0,0,2
murilo bustamante,3,1,0,0,4
muslim salikhov,8,4,0,0,12
myktybek orolbai,2,0,0,0,2
myles jury,8,4,0,0,12
na liang,0,1,0,0,1
nad narimani,2,2,0,0,4
nadia kassem,1,2,0,0,3
nah-shon burrell,1,1,0,0,2
nam phan,2,6,0,0,8
nandor guelmino,0,1,0,0,1
naoki inoue,1,1,0,0,2
naoyuki kotani,0,5,0,0,5
nasrat haqparast,9,4,0,0,13
nassourdine imavov,7,2,0,1,10
natalia silva,6,0,0,0,6
natan levy,2,2,0,0,4
nate diaz,16,11,0,0,27
nate landwehr,5,4,0,0,9
nate loughran,1,1,0,0,2
nate maness,5,2,0,0,7
nate marquardt,13,12,0,0,25
nate mohr,1,3,0,0,4
nate quarry,7,3,0,0,10
nate schroeder,0,1,0,0,1
nathan coy,1,2,0,0,3
nathan fletcher,1,0,0,0,1
nathaniel wood,8,2,0,0,10
navajo stirling,1,0,0,0,1
nazareno malegarie,0,1,0,0,1
nazim sadykhov,2,0,1,0,3
neil grove,0,1,0,0,1
neil magny,22,12,0,0,34
neil seery,3,4,0,0,7
neil wain,0,1,0,0,1
nicco montano,1,1,0,0,2
nicholas musoke,3,3,0,0,6
nick agallar,0,1,0,0,1
nick aguirre,0,2,0,0,2
nick catone,4,4,0,0,8
nick denis,1,1,0,0,2
nick diaz,7,7,0,1,15
nick fiore,0,2,0,0,2
nick hein,4,4,0,0,8
nick maximov,2,2,0,0,4
nick osipczak,2,3,0,0,5
nick pace,1,2,0,0,3
nick penner,0,2,0,0,2
nick ring,3,3,0,0,6
nick roehrick,0,1,0,0,1
nick sanzo,1,1,0,0,2
nick serra,0,1,0,0,1
nick thompson,1,1,0,0,2
nicolae negumereanu,4,2,0,0,6
nicolas dalby,7,4,1,1,13
nik lentz,14,9,1,1,25
nikita krylov,11,7,0,0,18
niklas backstrom,1,2,0,0,3
niklas stolze,0,3,0,0,3
niko price,8,8,0,2,18
nikolas motta,3,2,0,1,6
nikolay veretennikov,0,1,0,0,1
nina nunes,5,4,0,0,9
nissen osterneck,0,1,0,0,1
noad lahat,2,2,0,0,4
noe hernandez,0,1,0,0,1
nohelin hernandez,0,2,0,0,2
nolan ticman,0,2,0,0,2
nora cornolle,2,1,0,0,3
nordine taleb,7,5,0,0,12
norifumi yamamoto,0,3,0,1,4
norma dumont,8,2,0,0,10
norman parke,5,3,1,0,9
nursulton ruziboev,2,1,0,0,3
nurullo aliev,1,0,0,0,1
nyamjargal tumendemberel,0,1,0,0,1
oban elliott,3,0,0,0,3
ode osbourne,4,6,0,0,10
oleg taktarov,6,2,0,0,8
oli thompson,0,2,0,0,2
oliver enkamp,0,2,0,0,2
olivier aubin-mercier,7,5,0,0,12
oluwale bamgbose,1,4,0,0,5
omar morales,3,4,0,0,7
omari akhmedov,9,5,1,0,15
onassis parungao,1,0,0,0,1
orion cosce,1,2,0,0,3
orlando wiet,1,1,0,0,2
oskar piechota,2,3,0,1,6
ottman azaitar,2,3,0,0,5
oumar sy,2,0,0,0,2
ovince saint preux,15,13,0,0,28
ozzy diaz,0,1,0,0,1
pablo garza,3,3,0,0,6
paddy holohan,3,2,0,0,5
paddy pimblett,6,0,0,0,6
paige vanzant,5,4,0,0,9
pannie kianzad,5,6,0,0,11
papy abedi,1,3,0,0,4
parker porter,4,3,0,0,7
pascal krauss,2,2,0,0,4
pat audinwood,0,2,0,0,2
pat barry,5,7,0,0,12
pat healy,0,5,0,1,6
pat miletich,8,2,0,0,10
pat sabatini,6,2,0,0,8
pat schilling,0,2,0,0,2
patrick cote,10,11,0,0,21
patrick cummins,6,7,0,0,13
patrick smith,4,1,0,0,5
patrick walsh,1,1,0,0,2
patrick williams,1,3,0,0,4
paul bradley,0,2,0,0,2
paul buentello,3,3,0,0,6
paul craig,9,9,1,0,19
paul creighton,0,1,0,0,1
paul daley,2,1,0,0,3
paul felder,9,6,0,0,15
paul georgieff,0,1,0,0,1
paul herrera,0,1,0,0,1
paul jones,1,1,0,0,2
paul kelly,5,4,0,0,9
paul redmond,0,2,0,0,2
paul rodriguez,0,1,0,0,1
paul sass,3,2,0,0,5
paul taylor,4,5,0,0,9
paul varelans,4,4,0,0,8
paulo costa,6,4,0,0,10
paulo santos,0,1,0,0,1
paulo thiago,5,8,0,0,13
pawel pawlak,1,2,0,0,3
payton talbott,3,0,0,0,3
pearl gonzalez,0,2,0,0,2
pedro falcao,0,1,0,0,1
pedro munhoz,10,10,0,2,22
pedro nobre,0,0,0,1,1
pedro rizzo,9,5,0,0,14
peggy morgan,0,1,0,0,1
per eklund,1,2,0,0,3
pete rodriguez,1,2,0,0,3
pete sell,2,5,0,0,7
pete spratt,3,4,0,0,7
pete williams,3,5,0,0,8
peter barrett,0,2,0,0,2
peter sobotta,4,6,0,0,10
petr yan,10,4,0,0,14
phil baroni,3,7,0,0,10
phil davis,9,3,0,1,13
phil harris,1,3,0,1,5
phil hawes,4,4,0,0,8
phil johns,0,1,0,0,1
phil rowe,3,3,0,0,6
philip de fries,2,3,0,0,5
philipe lins,4,2,0,0,6
phillip miller,2,0,0,0,2
phillipe nover,1,6,0,0,7
piera rodriguez,3,2,0,0,5
pingyuan liu,2,2,0,0,4
piotr hallmann,2,4,0,0,6
poliana botelho,3,4,0,0,7
polyana viana,4,6,0,0,10
preston parsons,2,3,0,0,5
priscila cachoeira,4,6,0,0,10
puja tomar,1,0,0,0,1
punahele soriano,4,4,0,0,8
quang le,0,2,0,0,2
quinn mulhern,0,2,0,0,2
quinton jackson,8,5,0,0,13
rachael ostovich,1,3,0,0,4
rafa garcia,4,4,0,0,8
rafael alves,1,3,0,0,4
rafael carino,1,0,0,0,1
rafael cavalcante,1,4,0,0,5
rafael dos anjos,21,14,0,0,35
rafael estevam,1,0,0,0,1
rafael fiziev,6,3,0,0,9
rafael natal,9,7,1,0,17
rafaello oliveira,2,6,0,0,8
rainy martinez,0,1,0,0,1
ramazan emeev,5,3,0,0,8
ramazan temirov,1,0,0,0,1
rameau thierry sokoudjou,1,2,0,0,3
ramiro hernandez,0,2,0,0,2
ramiz brahimaj,3,3,0,0,6
ramon taveras,1,1,0,0,2
ramona pascual,0,3,0,0,3
ramsey nijem,5,5,0,0,10
randa markos,7,10,1,0,18
randy brown,13,6,0,0,19
randy costa,2,4,0,0,6
randy couture,16,8,0,0,24
rani yahya,13,6,1,1,21
raoni barcelos,7,4,0,0,11
raphael assuncao,12,7,0,0,19
raphael pessoa,1,2,0,0,3
raquel pennington,13,6,0,0,19
rashad coulter,1,3,0,0,4
rashad evans,14,8,1,0,23
rashid magomedov,5,1,0,0,6
raul rosas jr.,4,1,0,0,5
raulian paiva,3,4,0,0,7
ravena oliveira,0,1,0,0,1
ray borg,7,5,0,0,12
ray rodriguez,0,2,0,0,2
ray wizard,0,1,0,0,1
rayanne amanda,0,1,0,0,1
rayanne dos santos,0,1,0,0,1
razak al-hassan,0,2,0,0,2
reese andy,0,2,0,0,2
reginaldo vieira,1,2,0,0,3
rei tsuruya,1,0,0,0,1
reinier de ridder,1,0,0,0,1
remco pardoel,3,2,0,0,5
renan barao,9,8,0,0,17
renato moicano,12,5,0,0,17
renato sobral,6,4,0,0,10
renato verissimo,1,2,0,0,3
renee forte,1,3,0,0,4
renzo gracie,0,1,0,0,1
reuben duran,1,3,0,0,4
rex holman,0,1,0,0,1
reza madadi,3,4,0,0,7
reza nasri,0,1,0,0,1
rhys mckee,0,4,0,0,4
ricardo abreu,1,1,0,0,2
ricardo almeida,6,5,0,0,11
ricardo funch,0,4,0,0,4
ricardo lamas,11,6,0,0,17
ricardo ramos,8,5,0,0,13
ricardo romero,1,2,0,0,3
ricco rodriguez,5,2,0,0,7
rich attonito,3,2,0,0,5
rich clementi,5,5,0,0,10
rich franklin,14,6,0,0,20
richard crunkilton,0,1,0,0,1
richard walsh,2,4,0,0,6
richardson moreira,0,2,0,0,2
richie hightower,0,1,0,0,1
richie smullen,0,1,0,0,1
richie vaculik,1,3,0,0,4
rick davis,0,1,0,0,1
rick story,12,7,0,0,19
ricky glenn,4,6,1,0,11
ricky rainey,0,2,0,0,2
ricky simon,8,5,0,0,13
ricky turcios,2,2,0,0,4
riki fukuda,2,3,0,0,5
rin nakai,0,2,0,0,2
rinat fakhretdinov,4,0,1,0,5
rinya nakamura,2,0,0,0,2
roan carneiro,4,5,0,0,9
rob broughton,1,2,0,0,3
rob emerson,3,3,0,1,7
rob font,11,7,0,0,18
rob kimmons,3,4,0,0,7
rob macdonald,1,2,0,0,3
rob wilkinson,0,2,0,0,2
rob yundt,0,2,0,0,2
robbie lawler,15,10,0,0,25
robelis despaigne,1,2,0,0,3
robert bryczek,0,1,0,0,1
robert drysdale,0,0,0,1,1
robert lucarelli,0,1,0,0,1
robert mcdaniel,1,2,0,0,3
robert peralta,4,3,0,1,8
robert sanchez,1,2,0,0,3
robert valentin,0,1,0,0,1
robert whiteford,2,3,0,0,5
robert whittaker,17,5,0,0,22
roberto romero,0,1,0,0,1
roberto traven,1,1,0,0,2
rocky lee,0,1,0,0,1
rodney wallace,0,3,0,0,3
rodolfo bellato,1,0,0,0,1
rodolfo rubio perez,0,1,0,0,1
rodolfo vieira,5,2,0,0,7
rodrigo damm,3,4,0,0,7
rodrigo de lima,0,2,0,0,2
rodrigo nascimento,5,3,0,0,8
rodrigo ruas,0,1,0,0,1
roger bowling,0,2,0,1,3
roger gracie,0,1,0,0,1
roger hollett,0,2,0,0,2
roger huerta,6,2,0,0,8
roger narvaez,1,2,0,0,3
roger zapata,0,1,0,0,1
rogerio bontorin,2,3,0,1,6
rogerio nogueira,6,7,0,0,13
roland delorme,3,3,0,1,7
roland payne,0,1,0,0,1
rolando bedoya,0,2,0,0,2
rolando delgado,1,2,0,0,3
rolando dy,1,3,0,0,4
roldan sangcha'an,0,2,0,0,2
rolles gracie,0,1,0,0,1
roman bogatov,0,1,0,0,1
roman dolidze,8,3,0,0,11
roman kopylov,5,3,0,0,8
roman mitichyan,1,1,0,0,2
roman salazar,0,2,0,1,3
romie aram,0,1,0,0,1
ron faircloth,0,0,0,1,1
ron stallings,1,2,0,0,3
ron van clief,0,1,0,0,1
ron waterman,2,1,1,0,4
ronald jhun,0,1,0,0,1
ronaldo rodriguez,2,0,0,0,2
ronda rousey,6,2,0,0,8
rong zhu,1,2,0,0,3
rongzhu,0,1,0,0,1
ronnie lawrence,2,1,0,1,4
ronny markes,3,2,0,0,5
rony jason,4,4,0,1,9
ronys torres,0,2,0,0,2
roosevelt roberts,4,5,0,1,10
roque martinez,0,3,0,0,3
rory macdonald,9,4,0,0,13
rory markham,1,2,0,0,3
rory singer,2,2,0,0,4
rose namajunas,11,6,0,0,17
rosi sexton,0,2,0,0,2
ross pearson,12,13,0,1,26
ross pointon,0,2,0,0,2
rostem akman,0,2,0,0,2
rousimar palhares,8,4,0,0,12
roxanne modafferi,4,8,0,0,12
roy nelson,9,10,0,0,19
royce alger,0,2,0,0,2
royce gracie,8,1,0,0,9
royston wee,2,1,0,0,3
ruan potts,0,3,0,0,3
rudyard moncayo,0,1,0,0,1
ruslan magomedov,3,0,0,0,3
russell doane,3,5,0,0,8
rustam khabilov,10,3,0,0,13
ryan bader,15,5,0,0,20
ryan benoit,3,6,0,0,9
ryan couture,0,2,0,0,2
ryan hall,5,1,0,0,6
ryan janes,2,2,0,0,4
ryan jensen,2,6,0,0,8
ryan jimmo,3,4,0,0,7
ryan laflare,7,3,0,0,10
ryan loder,1,0,0,0,1
ryan macdonald,0,2,0,0,2
ryan madigan,0,1,0,0,1
ryan mcgillivray,0,1,0,0,1
ryan parker,0,1,0,0,1
ryan roberts,0,1,0,0,1
ryan spann,8,4,0,0,12
ryan thomas,0,2,0,0,2
ryo chonan,1,3,0,0,4
sabah homasi,0,3,0,0,3
sabina mazo,3,4,0,0,7
saeed hosseini,0,1,0,0,1
sage northcutt,6,2,0,0,8
sai wang,1,1,0,0,2
said nurmagomedov,6,2,0,0,8
saidyokub kakhramonov,2,1,0,0,3
saimon oliveira,0,2,0,0,2
sako chivitchian,0,1,0,0,1
salim touahri,0,3,0,0,3
sam adkins,2,2,0,0,4
sam alvey,10,13,1,0,24
sam fulton,0,2,0,0,2
sam hoger,2,3,0,0,5
sam hughes,4,5,0,0,9
sam patterson,2,1,0,0,3
sam sicilia,5,7,0,0,12
sam stout,9,11,0,0,20
sammy morgan,0,2,0,0,2
samy schiavo,0,2,0,0,2
sanae kikuta,1,0,0,0,1
santiago ponzinibbio,11,7,0,0,18
saparbeg safarov,1,3,0,0,4
sara mcmann,7,6,0,0,13
sarah alpar,0,2,0,0,2
sarah frota,0,2,0,0,2
sarah kaufman,1,2,0,1,4
sarah moras,3,6,0,0,9
sasha palatnikov,1,2,0,0,3
satoshi honma,0,1,0,0,1
scott adams,1,0,0,0,1
scott askham,2,4,0,0,6
scott baker,0,1,0,0,1
scott bessac,1,1,0,0,2
scott ferrozzo,3,2,0,0,5
scott fiedler,0,1,0,0,1
scott holtzman,7,6,0,0,13
scott jorgensen,4,8,0,0,12
scott junk,0,1,0,0,1
scott morris,1,1,0,0,2
scott smith,1,3,0,0,4
sean alvarez,0,1,0,0,1
sean brady,7,1,0,0,8
sean daugherty,0,1,0,0,1
sean gannon,0,1,0,0,1
sean mccorkle,1,2,0,0,3
sean o'connell,2,5,0,0,7
sean o'malley,10,2,0,1,13
sean pierson,4,2,0,0,6
sean salmon,0,2,0,0,2
sean sharaf,0,1,0,0,1
sean sherk,8,4,0,0,12
sean soriano,0,5,0,0,5
sean spencer,3,5,0,0,8
sean strickland,16,6,0,0,22
sean woodson,7,1,1,0,9
sedriques dumas,2,2,0,0,4
semmy schilt,1,1,0,0,2
seo hee ham,1,3,0,0,4
sergei pavlovich,6,3,0,0,9
sergey khandozhko,2,1,0,0,3
sergey morozov,3,2,0,0,5
serghei spivac,8,4,0,0,12
sergio moraes,8,5,1,0,14
sergio pettis,9,5,0,0,14
serhiy sidey,1,1,0,0,2
seth baczynski,5,6,0,0,11
seth petruzelli,0,4,0,0,4
seungguk choi,0,1,0,0,1
seungwoo choi,3,6,0,0,9
shamar bailey,1,2,0,0,3
shamil abdurakhimov,5,6,0,0,11
shamil gamzatov,1,1,0,0,2
shamil gaziev,2,1,0,0,3
shana dobson,2,4,0,0,6
shane burgos,8,3,0,0,11
shane campbell,1,4,0,0,5
shane carwin,4,2,0,0,6
shane del rosario,0,2,0,0,2
shane howell,0,2,0,0,2
shane nelson,2,2,0,0,4
shane primm,0,1,0,0,1
shane roller,2,4,0,0,6
shane young,2,5,0,0,7
shanna young,1,3,0,0,4
shannon gugerty,2,3,0,0,5
shannon ross,0,3,0,0,3
shara magomedov,2,0,0,0,2
shauna bannon,1,1,0,0,2
shavkat rakhmonov,7,0,0,0,7
shawn jordan,6,4,0,0,10
shayilan nuerdanbieke,3,3,0,0,6
shayna baszler,0,2,0,0,2
sheila gaff,0,2,0,0,2
sheldon westcott,1,2,0,0,3
sherman pendergarst,0,1,0,0,1
sheymon moraes,2,3,0,0,5
shi ming,1,0,0,0,1
shinsho anzai,2,2,0,0,4
shonie carter,3,3,0,0,6
shunichi shimizu,0,1,0,0,1
sijara eubanks,5,5,0,0,10
silvana gomez juarez,1,3,0,0,4
simeon thoresen,1,2,0,0,3
sione latu,1,0,0,0,1
sirwan kakai,1,1,0,0,2
siyar bahadurzada,4,4,0,0,8
soa palelei,4,3,0,0,7
sodiq yusuff,6,3,0,0,9
solomon hutcherson,0,1,0,0,1
song kenan,5,5,0,0,10
song yadong,10,3,1,0,14
spencer fisher,9,8,0,0,17
spike carlyle,1,2,0,0,3
stanislav nedkov,1,2,0,1,4
stefan sekulic,0,2,0,0,2
stefan struve,13,11,0,0,24
stephan bonnar,8,7,0,0,15
stephanie egger,3,4,0,0,7
stephanie luciano,1,0,0,0,1
stephen bass,0,1,0,0,1
stephen thompson,12,8,1,0,21
steve berger,0,2,0,1,3
steve bosse,2,1,0,0,3
steve bruno,1,2,0,0,3
steve byrnes,0,1,0,0,1
steve cantwell,1,5,0,0,6
steve erceg,3,2,0,0,5
steve garcia,6,2,0,0,8
steve jennum,2,1,0,0,3
steve judson,0,2,0,0,2
steve kennedy,0,2,0,0,2
steve lopez,0,2,0,0,2
steve montgomery,0,2,0,0,2
steve nelmark,2,1,0,0,3
steve steinbeiss,0,2,0,0,2
steve vigneault,0,1,0,0,1
steven graham,1,1,0,0,2
steven koslow,0,1,0,0,1
steven nguyen,0,1,0,0,1
steven peterson,3,5,0,0,8
steven siler,5,4,0,0,9
stevie lynch,0,1,0,0,1
stevie ray,7,4,0,0,11
stewart nicoll,0,1,0,0,1
stipe miocic,14,5,0,0,19
sultan aliev,2,2,0,0,4
suman mokhtarian,0,2,0,0,2
sumudaerji,3,4,0,0,7
sung bin jo,0,1,0,0,1
suyoung you,1,0,0,0,1
syuri kondo,1,3,0,0,4
tabatha ricci,6,3,0,0,9
tae hyun bang,2,3,0,0,5
tafon nchukwi,2,4,0,0,6
tagir ulanbekov,4,1,0,0,5
tai bowden,1,1,0,0,2
tai tuivasa,8,8,0,0,16
taila santos,4,2,0,0,6
tainara lisboa,2,0,0,0,2
takanori gomi,4,9,0,0,13
takashi sato,2,5,0,0,7
takenori sato,0,2,0,0,2
takeya mizugaki,8,6,0,0,14
talita alencar,1,1,0,0,2
talita bernardo,1,3,0,0,4
tamdan mccrory,4,5,0,0,9
tamires vidal,1,3,0,0,4
tanner boser,5,5,0,0,10
tarec saffiedine,2,4,0,0,6
tateki matsuda,0,2,0,0,2
tatiana suarez,7,0,0,0,7
tatsuro taira,6,1,0,0,7
tatsuya kawajiri,3,3,0,0,6
taylor lapilus,6,2,0,0,8
te edwards,0,2,0,0,2
tecia pennington,1,1,0,0,2
tecia torres,9,6,0,0,15
tedd williams,1,1,0,0,2
teemu packalen,1,3,0,0,4
tereza bleda,1,1,0,0,2
terrance mckinney,5,4,0,0,9
terrence mitchell,0,2,0,0,2
terrion ware,0,4,0,0,4
terry etim,6,5,0,0,11
terry martin,2,4,0,0,6
teruto ishihara,3,5,1,0,9
thaddeus luster,0,1,0,0,1
thales leites,13,8,0,0,21
themba gorimbo,4,2,0,0,6
thiago alves,15,12,0,0,27
thiago moises,7,6,0,0,13
thiago perpetuo,1,2,0,0,3
thiago santos,14,10,0,0,24
thiago silva,7,3,0,2,12
thiago tavares,10,7,1,0,18
thibault gouti,1,5,0,0,6
thomas almeida,5,5,0,0,10
thomas gifford,0,2,0,0,2
thomas petersen,1,1,0,0,2
thomas ramirez,0,1,0,0,1
tiago dos santos e silva,2,2,0,0,4
tiki ghosn,0,4,0,0,4
tim boetsch,12,12,0,0,24
tim credeur,3,2,0,0,5
tim elliott,9,10,0,0,19
tim gorman,0,2,0,0,2
tim hague,1,4,0,0,5
tim kennedy,3,2,0,0,5
tim lajcik,0,2,1,0,3
tim mckenzie,0,1,0,0,1
tim means,15,14,0,1,30
tim sylvia,9,4,0,0,13
tim williams,0,2,0,0,2
timmy cuamba,0,2,0,0,2
timothy johnson,4,3,0,0,7
timur valiev,2,1,0,1,4
tina lahdemaki,0,1,0,0,1
tito ortiz,15,11,1,0,27
tj brown,3,5,0,0,8
tj dillashaw,13,5,0,0,18
tj grant,8,3,0,0,11
tj laramie,0,2,0,0,2
tj o'brien,0,2,0,0,2
tj waldburger,4,4,0,0,8
todd brown,0,2,0,0,2
todd butler,0,1,0,0,1
todd duffee,3,2,0,1,6
todd medina,1,1,0,0,2
tom aspinall,8,1,0,0,9
tom blackledge,0,1,0,0,1
tom breese,5,3,0,0,8
tom deblass,0,2,0,0,2
tom duquesnoy,2,1,0,0,3
tom egan,0,1,0,0,1
tom gallicchio,0,1,0,0,1
tom lawlor,6,5,0,0,11
tom murphy,1,0,0,0,1
tom niinimaki,1,3,0,0,4
tom nolan,2,1,0,0,3
tom watson,2,5,0,0,7
tomasz drwal,3,3,0,0,6
tommy hayden,0,2,0,0,2
tommy speer,0,2,0,0,2
tony desouza,3,3,0,0,6
tony ferguson,15,9,0,0,24
tony fryklund,2,2,0,0,4
tony gravely,4,4,0,0,8
tony halme,0,1,0,0,1
tony kelley,2,2,0,0,4
tony petarra,0,1,0,0,1
tony sims,1,2,0,0,3
tonya evinger,0,3,0,0,3
tor troeng,1,3,0,0,4
toshiomi kazama,1,1,0,0,2
townsend saunders,0,2,0,0,2
tra telligman,1,4,0,0,5
tracy cortez,5,1,0,0,6
travis browne,9,7,1,0,17
travis fulton,1,1,0,0,2
travis lutter,2,4,0,0,6
travis wiuff,0,2,0,0,2
trent jenkins,0,1,0,0,1
tresean gore,2,2,0,0,4
trevin giles,7,7,0,0,14
trevin jones,1,4,0,1,6
trevor peek,1,3,0,0,4
trevor prangley,2,2,0,0,4
trevor smith,5,7,0,0,12
trey ogden,3,2,0,1,6
trey waters,2,0,0,0,2
tristan connelly,1,2,0,0,3
troy mandaloniz,1,1,0,0,2
tsuyoshi kohsaka,3,3,0,0,6
tucker lutz,1,3,0,0,4
tuco tokkos,0,2,0,0,2
tulio palhares,1,0,0,0,1
tyler diamond,0,1,0,0,1
tyler toner,0,1,0,0,1
tyron woodley,9,6,1,0,16
tyrone roberts,1,0,0,0,1
tyson griffin,8,6,0,0,14
tyson nam,3,5,0,0,8
tyson pedro,6,5,0,0,11
ulysses gomez,0,2,0,0,2
umar nurmagomedov,6,0,0,0,6
uriah hall,10,9,0,0,19
urijah faber,11,7,0,0,18
uros medic,4,2,0,0,6
vagner rocha,1,3,0,0,4
val woodburn,0,2,0,0,2
valentina shevchenko,13,3,1,0,17
valeri ignatov,0,2,0,0,2
valerie letourneau,3,3,0,0,6
valmir lazaro,1,2,0,0,3
valter walker,1,1,0,0,2
vanessa demopoulos,5,3,0,0,8
vanessa melo,1,3,0,0,4
vaughan lee,3,5,0,0,8
vernon ramos ho,0,1,0,0,1
vernon white,0,1,1,0,2
veronica hardy,3,1,0,0,4
veronica macedo,1,4,0,0,5
viacheslav borshchev,3,3,1,0,7
vicente luque,16,6,0,0,22
victor altamirano,2,4,0,0,6
victor henry,3,2,0,0,5
victor hugo,1,0,0,0,1
victor martinez,0,2,0,0,2
victor rodriguez,0,2,0,0,2
victor valimaki,0,2,0,0,2
victoria leonardo,1,4,0,0,5
vik grujic,1,3,0,0,4
viktor pesta,1,4,0,0,5
viktoriia dudakova,1,1,0,0,2
vinc pichel,7,4,0,0,11
vince cachero,0,2,0,0,2
vince morales,3,6,0,0,9
vinicius moreira,0,4,0,0,4
vinicius oliveira,2,0,0,0,2
vinicius queiroz,0,1,0,0,1
vinicius salvador,0,3,0,0,3
vinny magalhaes,1,4,0,0,5
virna jandiroba,7,3,0,0,10
viscardi andrade,3,1,0,0,4
vitor belfort,15,10,0,1,26
vitor miranda,3,4,0,0,7
vitor petrino,4,2,0,0,6
viviane araujo,7,5,0,0,12
viviane pereira,2,2,0,0,4
vladimir matyushenko,7,5,0,0,12
volkan oezdemir,8,7,0,0,15
wade shipp,0,1,0,0,1
wagner campos,0,1,0,0,1
wagner prado,0,2,0,1,3
wagner silva,0,2,0,0,2
waldo cortes-acosta,4,1,0,0,5
walel watson,1,3,0,0,4
wallid ismail,0,1,0,0,1
walt harris,6,9,0,1,16
wanderlei silva,5,7,0,0,12
wang cong,1,1,0,0,2
wang guan,1,0,0,0,1
war machine,1,1,0,0,2
warlley alves,8,7,0,0,15
waylon lowe,2,2,0,0,4
wellington turman,3,6,0,0,9
wendell oliveira marques,0,2,0,0,2
wes albritton,0,1,0,0,1
wes combs,0,2,0,0,2
wes sims,0,3,0,0,3
wesley correira,2,2,0,0,4
westin wilson,1,2,0,0,3
will brooks,1,3,0,0,4
will campuzano,0,4,0,0,4
will chope,0,1,0,0,1
willamy freire,0,1,0,0,1
william gomis,4,0,0,0,4
william knight,3,4,0,0,7
william macario,1,3,0,0,4
willie gates,1,3,0,0,4
wilson gouveia,6,4,0,0,10
wilson reis,7,6,0,0,13
wu yanan,1,5,0,0,6
wuliji buren,0,3,0,0,3
xavier foupa-pokam,0,2,0,0,2
xiao long,1,1,0,0,2
yair rodriguez,10,4,0,1,15
yan cabral,2,3,0,0,5
yan xiaonan,9,3,0,0,12
yana kunitskaya,4,3,0,0,7
yana santos,1,2,0,0,3
yanal ashmouz,2,1,0,0,3
yancy medeiros,6,8,0,1,15
yanis ghemmouri,0,2,0,0,2
yao zhikui,1,3,0,0,4
yaotzin meza,2,4,0,1,7
yasuhiro urushitani,0,2,0,0,2
yazmin jauregui,3,2,0,0,5
yi zha,0,1,0,0,1
yizha,0,1,0,0,1
yoel romero,9,4,0,0,13
yohan lainesse,1,3,0,0,4
yoislandy izquierdo,0,2,0,0,2
yoji anjo,0,3,0,0,3
yorgan de castro,1,3,0,0,4
yosdenis cedeno,1,3,0,0,4
yoshihiro akiyama,2,5,0,0,7
yoshiki takahashi,1,0,0,0,1
yoshinori horie,0,1,0,0,1
yoshiyuki yoshida,2,3,0,0,5
youssef zalal,6,3,1,0,10
yui chul nam,1,2,0,0,3
yuki kondo,1,2,0,0,3
yuki sasaki,0,1,0,0,1
yuri vaulin,0,1,0,0,1
yuri villefort,0,2,0,0,2
yusaku kinoshita,0,1,0,0,1
yushin okami,14,7,0,0,21
yusuke kasuya,0,2,0,0,2
yuta sasaki,4,5,0,0,9
yves edwards,10,10,0,1,21
yves jabouin,5,5,0,0,10
zabit magomedsharipov,6,0,0,0,6
zac pauga,1,3,0,0,4
zach light,0,1,0,0,1
zach makovsky,3,4,0,0,7
zach reese,1,1,0,0,2
zachary reese,1,0,0,0,1
zachary scroggin,0,1,0,0,1
zak cummings,10,4,0,0,14
zak ottow,4,4,0,0,8
zane frazier,0,1,0,0,1
zarah fairn,0,4,0,0,4
zarrukh adashev,1,3,0,0,4
zelim imadaev,0,3,0,0,3
zhalgas zhumagulov,1,6,0,0,7
zhang lipeng,2,2,0,0,4
zhang mingyang,2,0,0,0,2
zhang tiequan,1,3,0,0,4
zhang weili,9,2,0,0,11
zubaira tukhugov,5,3,1,0,9
zviad lazishvili,0,1,0,0,1
zygimantas ramaska,0,1,0,0,1
